"Patient_Seen_End_Date","GEOGRAPHY","CCG","AT_Code","Region_Code","Adult","Child","Total","AdultPopulation","ChildPopulation","TotalPopulation"
"31-Jul-15","NHS","00C","Q45","Y54",49986,17724,67710,82637,22759,105396
"31-Jul-15","NHS","00D","Q45","Y54",121953,37358,159311,217698,55205,272903
"31-Jul-15","NHS","00J","Q45","Y54",101567,30678,132245,198042,45012,243054
"31-Jul-15","NHS","00K","Q45","Y54",133074,46712,179786,223398,62463,285861
"31-Jul-15","NHS","00L","Q49","Y54",141064,41807,182871,255418,60388,315806
"31-Jul-15","NHS","00M","Q45","Y54",139727,46760,186487,214691,59193,273884
"31-Jul-15","NHS","00N","Q49","Y54",81024,22990,104014,119084,29442,148526
"31-Jul-15","NHS","00P","Q49","Y54",136990,43419,180409,221536,54544,276080
"31-Jul-15","NHS","00Q","Q47","Y54",58519,29773,88292,108833,38536,147369
"31-Jul-15","NHS","00R","Q47","Y54",63332,19190,82522,112370,29030,141400
"31-Jul-15","NHS","00T","Q46","Y54",108634,47224,155858,214210,65847,280057
"31-Jul-15","NHS","00V","Q46","Y54",76742,29884,106626,144168,42359,186527
"31-Jul-15","NHS","00W","Q46","Y54",73611,35695,109306,140813,41410,182223
"31-Jul-15","NHS","00X","Q47","Y54",73728,27700,101428,133938,35553,169491
"31-Jul-15","NHS","00Y","Q46","Y54",101015,42272,143287,170144,57168,227312
"31-Jul-15","NHS","01A","Q47","Y54",158763,62716,221479,288807,83535,372342
"31-Jul-15","NHS","01C","Q44","Y54",101837,33545,135382,156939,38558,195497
"31-Jul-15","NHS","01D","Q46","Y54",92188,37713,129901,161558,50562,212120
"31-Jul-15","NHS","01E","Q47","Y54",69661,27553,97214,159213,42463,201676
"31-Jul-15","NHS","01F","Q48","Y54",53034,17459,70493,97818,28152,125970
"31-Jul-15","NHS","01G","Q46","Y54",108631,42282,150913,186744,52269,239013
"31-Jul-15","NHS","01H","Q49","Y54",200879,67156,268035,409076,95062,504138
"31-Jul-15","NHS","01J","Q48","Y54",67949,23373,91322,113703,32383,146086
"31-Jul-15","NHS","01K","Q47","Y54",60958,20014,80972,129492,29964,159456
"31-Jul-15","NHS","01M","Q46","Y54",82375,29396,111771,132730,37922,170652
"31-Jul-15","NHS","01N","Q46","Y54",55539,21161,76700,128066,33476,161542
"31-Jul-15","NHS","01R","Q44","Y54",80479,27144,107623,140838,36372,177210
"31-Jul-15","NHS","01T","Q48","Y54",78688,22458,101146,126858,32014,158872
"31-Jul-15","NHS","01V","Q48","Y54",71704,19316,91020,92788,21547,114335
"31-Jul-15","NHS","01W","Q46","Y54",140320,45353,185673,224011,61021,285032
"31-Jul-15","NHS","01X","Q48","Y54",90862,28987,119849,139950,36271,176221
"31-Jul-15","NHS","01Y","Q46","Y54",113515,40565,154080,197934,55743,253677
"31-Jul-15","NHS","02A","Q46","Y54",97028,39760,136788,177254,52925,230179
"31-Jul-15","NHS","02D","Q44","Y54",42185,16346,58531,80153,21875,102028
"31-Jul-15","NHS","02E","Q44","Y54",92454,31140,123594,160810,44299,205109
"31-Jul-15","NHS","02F","Q44","Y54",126757,40066,166823,184750,44248,228998
"31-Jul-15","NHS","02G","Q47","Y54",44682,16469,61151,88957,22357,111314
"31-Jul-15","NHS","02H","Q46","Y54",151849,51060,202909,251917,67773,319690
"31-Jul-15","NHS","02M","Q47","Y54",83473,22330,105803,135694,30103,165797
"31-Jul-15","NHS","02N","Q52","Y54",65432,23355,88787,123814,34662,158476
"31-Jul-15","NHS","02P","Q51","Y54",120108,38386,158494,186297,49460,235757
"31-Jul-15","NHS","02Q","Q51","Y54",54109,16151,70260,90737,22917,113654
"31-Jul-15","NHS","02R","Q52","Y54",112890,48832,161722,247194,87432,334626
"31-Jul-15","NHS","02T","Q52","Y54",94345,34927,129272,160676,45679,206355
"31-Jul-15","NHS","02V","Q52","Y54",96593,33756,130349,157266,42678,199944
"31-Jul-15","NHS","02W","Q52","Y54",47017,27487,74504,57079,25660,82739
"31-Jul-15","NHS","02X","Q51","Y54",165940,51537,217477,238646,64976,303622
"31-Jul-15","NHS","02Y","Q50","Y54",116404,35959,152363,255311,59249,314560
"31-Jul-15","NHS","03A","Q52","Y54",103583,38520,142103,188691,51708,240399
"31-Jul-15","NHS","03C","Q52","Y54",126424,42486,168910,260312,60186,320498
"31-Jul-15","NHS","03D","Q50","Y54",62095,21191,83286,124990,28648,153638
"31-Jul-15","NHS","03E","Q50","Y54",58601,22023,80624,124886,33363,158249
"31-Jul-15","NHS","03F","Q50","Y54",159194,51293,210487,202325,55264,257589
"31-Jul-15","NHS","03G","Q52","Y54",105585,41376,146961,185330,55709,241039
"31-Jul-15","NHS","03H","Q50","Y54",75542,23892,99434,125404,34423,159827
"31-Jul-15","NHS","03J","Q52","Y54",83792,36150,119942,141619,46261,187880
"31-Jul-15","NHS","03K","Q50","Y54",61812,21510,83322,133409,35351,168760
"31-Jul-15","NHS","03L","Q51","Y54",123046,41109,164155,202588,56101,258689
"31-Jul-15","NHS","03M","Q50","Y54",43446,13974,57420,89607,20529,110136
"31-Jul-15","NHS","03N","Q51","Y54",264851,86771,351622,445431,114654,560085
"31-Jul-15","NHS","03Q","Q50","Y54",153353,46271,199624,283313,65753,349066
"31-Jul-15","NHS","03R","Q52","Y54",170245,52994,223239,260843,68865,329708
"31-Jul-15","NHS","03T","Q59","Y55",95650,25444,121094,187036,42388,229424
"31-Jul-15","NHS","03V","Q58","Y55",27034,9820,36854,49002,15210,64212
"31-Jul-15","NHS","03W","Q59","Y55",116907,43160,160067,255340,66582,321922
"31-Jul-15","NHS","03X","Q55","Y55",54492,14817,69309,75345,19585,94930
"31-Jul-15","NHS","03Y","Q55","Y55",40920,12274,53194,87499,21751,109250
"31-Jul-15","NHS","04C","Q59","Y55",141624,63407,205031,254324,79488,333812
"31-Jul-15","NHS","04D","Q59","Y55",95721,30379,126100,185088,44536,229624
"31-Jul-15","NHS","04E","Q55","Y55",89588,29786,119374,153265,40641,193906
"31-Jul-15","NHS","04F","Q58","Y55",84383,44685,129068,196095,65262,261357
"31-Jul-15","NHS","04G","Q58","Y55",256217,94959,351176,486324,140251,626575
"31-Jul-15","NHS","04H","Q55","Y55",43777,14915,58692,93050,23903,116953
"31-Jul-15","NHS","04J","Q55","Y55",123559,40769,164328,220313,51843,272156
"31-Jul-15","NHS","04K","Q55","Y55",144416,51543,195959,246983,63854,310837
"31-Jul-15","NHS","04L","Q55","Y55",79424,24826,104250,117304,30321,147625
"31-Jul-15","NHS","04M","Q55","Y55",42403,13308,55711,89783,21460,111243
"31-Jul-15","NHS","04N","Q55","Y55",37265,16107,53372,89437,23398,112835
"31-Jul-15","NHS","04Q","Q59","Y55",40173,15233,55406,97208,25634,122842
"31-Jul-15","NHS","04R","Q55","Y55",165655,63676,229331,405788,112379,518167
"31-Jul-15","NHS","04V","Q59","Y55",156674,53162,209836,301417,75842,377259
"31-Jul-15","NHS","04X","Q54","Y55",100345,37263,137608,151704,49451,201155
"31-Jul-15","NHS","04Y","Q60","Y55",51546,15759,67305,106089,27498,133587
"31-Jul-15","NHS","05A","Q53","Y55",178949,64044,242993,335514,95669,431183
"31-Jul-15","NHS","05C","Q54","Y55",128064,38163,166227,246783,67644,314427
"31-Jul-15","NHS","05D","Q60","Y55",55959,22874,78833,97566,27012,124578
"31-Jul-15","NHS","05F","Q53","Y55",75148,24043,99191,150027,36060,186087
"31-Jul-15","NHS","05G","Q60","Y55",86236,27638,113874,173683,40758,214441
"31-Jul-15","NHS","05H","Q53","Y55",86153,28297,114450,148583,39544,188127
"31-Jul-15","NHS","05J","Q53","Y55",71640,26118,97758,141371,37894,179265
"31-Jul-15","NHS","05L","Q54","Y55",208271,79321,287592,358104,122025,480129
"31-Jul-15","NHS","05N","Q60","Y55",120264,40996,161260,248550,60017,308567
"31-Jul-15","NHS","05P","Q54","Y55",73443,28042,101485,163587,45274,208861
"31-Jul-15","NHS","05Q","Q60","Y55",98895,32698,131593,179641,44842,224483
"31-Jul-15","NHS","05R","Q53","Y55",116930,37491,154421,209336,49893,259229
"31-Jul-15","NHS","05T","Q53","Y55",117682,39653,157335,236565,57917,294482
"31-Jul-15","NHS","05V","Q60","Y55",55868,18189,74057,122990,28715,151705
"31-Jul-15","NHS","05W","Q60","Y55",127255,45273,172528,201959,56481,258440
"31-Jul-15","NHS","05X","Q60","Y55",76381,29502,105883,129499,38953,168452
"31-Jul-15","NHS","05Y","Q54","Y55",100919,41901,142820,208276,63885,272161
"31-Jul-15","NHS","06A","Q54","Y55",98268,34319,132587,194708,56849,251557
"31-Jul-15","NHS","06D","Q53","Y55",33819,13684,47503,79270,19151,98421
"31-Jul-15","NHS","06F","Q58","Y55",172384,66910,239294,331145,94765,425910
"31-Jul-15","NHS","06H","Q56","Y55",311534,122396,433930,671453,183539,854992
"31-Jul-15","NHS","06K","Q58","Y55",244342,91136,335478,425601,120649,546250
"31-Jul-15","NHS","06L","Q56","Y55",164223,54346,218569,313699,82449,396148
"31-Jul-15","NHS","06M","Q56","Y55",128863,32204,161067,171450,42308,213758
"31-Jul-15","NHS","06N","Q58","Y55",219467,98195,317662,441948,133844,575792
"31-Jul-15","NHS","06P","Q58","Y55",78956,34249,113205,154310,53679,207989
"31-Jul-15","NHS","06Q","Q57","Y55",172886,54919,227805,301090,80440,381530
"31-Jul-15","NHS","06T","Q57","Y55",138000,44364,182364,253628,62719,316347
"31-Jul-15","NHS","06V","Q56","Y55",65802,16553,82355,138831,29632,168463
"31-Jul-15","NHS","06W","Q56","Y55",125832,33996,159828,159019,35953,194972
"31-Jul-15","NHS","06Y","Q56","Y55",105081,30043,135124,188892,48538,237430
"31-Jul-15","NHS","07G","Q57","Y55",49987,22669,72656,121434,39415,160849
"31-Jul-15","NHS","07H","Q57","Y55",90520,34094,124614,228188,65037,293225
"31-Jul-15","NHS","07J","Q56","Y55",57966,16294,74260,138857,32628,171485
"31-Jul-15","NHS","07K","Q56","Y55",103984,34697,138681,177643,46145,223788
"31-Jul-15","NHS","07L","Q71","Y56",75064,33912,108976,136747,57605,194352
"31-Jul-15","NHS","07M","Q71","Y56",102344,49457,151801,282465,86623,369088
"31-Jul-15","NHS","07N","Q71","Y56",75602,34520,110122,181780,54907,236687
"31-Jul-15","NHS","07P","Q71","Y56",119410,48248,167658,244716,72548,317264
"31-Jul-15","NHS","07Q","Q71","Y56",92422,49845,142267,247450,70449,317899
"31-Jul-15","NHS","07R","Q71","Y56",97843,29204,127047,187334,42385,229719
"31-Jul-15","NHS","07T","Q71","Y56",77841,26467,104308,205220,59807,265027
"31-Jul-15","NHS","07V","Q71","Y56",133261,56799,190060,281124,91628,372752
"31-Jul-15","NHS","07W","Q71","Y56",141088,58050,199138,262978,79516,342494
"31-Jul-15","NHS","07X","Q71","Y56",113415,50017,163432,239600,80924,320524
"31-Jul-15","NHS","07Y","Q71","Y56",106547,43814,150361,201963,60444,262407
"31-Jul-15","NHS","08A","Q71","Y56",107039,48236,155275,200318,63690,264008
"31-Jul-15","NHS","08C","Q71","Y56",76075,21847,97922,145357,33328,178685
"31-Jul-15","NHS","08D","Q71","Y56",113209,46737,159946,204425,58961,263386
"31-Jul-15","NHS","08E","Q71","Y56",78547,33399,111946,187629,55743,243372
"31-Jul-15","NHS","08F","Q71","Y56",94269,34642,128911,189960,52120,242080
"31-Jul-15","NHS","08G","Q71","Y56",87874,39233,127107,219259,67547,286806
"31-Jul-15","NHS","08H","Q71","Y56",80205,22329,102534,177322,38345,215667
"31-Jul-15","NHS","08J","Q71","Y56",61779,26860,88639,131100,35693,166793
"31-Jul-15","NHS","08K","Q71","Y56",138062,40927,178989,252274,61968,314242
"31-Jul-15","NHS","08L","Q71","Y56",121014,42096,163110,220491,65689,286180
"31-Jul-15","NHS","08M","Q71","Y56",93486,47986,141472,237000,81227,318227
"31-Jul-15","NHS","08N","Q71","Y56",113181,53245,166426,215220,73052,288272
"31-Jul-15","NHS","08P","Q71","Y56",47253,24491,71744,148509,42856,191365
"31-Jul-15","NHS","08Q","Q71","Y56",107973,36802,144775,237369,61095,298464
"31-Jul-15","NHS","08R","Q71","Y56",71350,23582,94932,158248,44975,203223
"31-Jul-15","NHS","08T","Q71","Y56",67163,30214,97377,151229,44685,195914
"31-Jul-15","NHS","08V","Q71","Y56",81775,30997,112772,212378,60512,272890
"31-Jul-15","NHS","08W","Q71","Y56",84021,35000,119021,202000,63797,265797
"31-Jul-15","NHS","08X","Q71","Y56",107337,38696,146033,252281,58235,310516
"31-Jul-15","NHS","08Y","Q71","Y56",82667,22055,104722,180239,39512,219751
"31-Jul-15","NHS","09A","Q71","Y56",59641,13425,73066,135765,26919,162684
"31-Jul-15","NHS","09C","Q67","Y57",44540,18681,63221,93288,28435,121723
"31-Jul-15","NHS","09D","Q68","Y57",106676,36709,143385,227451,50661,278112
"31-Jul-15","NHS","09E","Q67","Y57",71558,28780,100338,163771,38618,202389
"31-Jul-15","NHS","09F","Q68","Y57",69916,21842,91758,148747,34735,183482
"31-Jul-15","NHS","09G","Q68","Y57",175756,60439,236195,389667,90518,480185
"31-Jul-15","NHS","09H","Q68","Y57",50003,20297,70300,83450,25521,108971
"31-Jul-15","NHS","09J","Q67","Y57",78132,33291,111423,195263,56614,251877
"31-Jul-15","NHS","09L","Q68","Y57",63709,27572,91281,137822,40091,177913
"31-Jul-15","NHS","09N","Q68","Y57",62145,29743,91888,163414,44358,207772
"31-Jul-15","NHS","09P","Q68","Y57",80422,22097,102519,146503,35305,181808
"31-Jul-15","NHS","09W","Q67","Y57",116849,50291,167140,209266,61839,271105
"31-Jul-15","NHS","09X","Q68","Y57",98416,41883,140299,175516,49806,225322
"31-Jul-15","NHS","09Y","Q68","Y57",101405,51063,152468,265796,74403,340199
"31-Jul-15","NHS","10A","Q67","Y57",80070,26964,107034,162461,41157,203618
"31-Jul-15","NHS","10C","Q68","Y57",21599,12879,34478,74002,20395,94397
"31-Jul-15","NHS","10D","Q67","Y57",33587,14668,48255,84309,25332,109641
"31-Jul-15","NHS","10E","Q67","Y57",52123,16317,68440,107152,29614,136766
"31-Jul-15","NHS","10G","Q69","Y57",55851,23315,79166,102485,31874,134359
"31-Jul-15","NHS","10H","Q69","Y57",98064,46251,144315,246305,73137,319442
"31-Jul-15","NHS","10J","Q70","Y57",84367,32896,117263,168966,48845,217811
"31-Jul-15","NHS","10K","Q70","Y57",75317,27288,102605,156661,40456,197117
"31-Jul-15","NHS","10L","Q70","Y57",60512,17593,78105,112702,25691,138393
"31-Jul-15","NHS","10M","Q69","Y57",42110,17010,59120,81354,24358,105712
"31-Jul-15","NHS","10N","Q69","Y57",14371,10423,24794,76712,23195,99907
"31-Jul-15","NHS","10Q","Q69","Y57",259589,103697,363286,515117,137206,652323
"31-Jul-15","NHS","10R","Q70","Y57",87181,29793,116974,164660,42800,207460
"31-Jul-15","NHS","10T","Q69","Y57",50441,24919,75360,104010,39014,143024
"31-Jul-15","NHS","10V","Q70","Y57",73207,27820,101027,166327,43567,209894
"31-Jul-15","NHS","10W","Q69","Y57",59144,24312,83456,85769,23251,109020
"31-Jul-15","NHS","10X","Q70","Y57",102282,34032,136314,194254,47887,242141
"31-Jul-15","NHS","10Y","Q69","Y57",58376,28027,86403,154056,45405,199461
"31-Jul-15","NHS","11A","Q70","Y57",222151,76765,298916,436487,111527,548014
"31-Jul-15","NHS","11C","Q69","Y57",42251,19782,62033,109699,30166,139865
"31-Jul-15","NHS","11D","Q69","Y57",48634,22857,71491,121369,36497,157866
"31-Jul-15","NHS","11E","Q64","Y57",75101,28029,103130,145883,34214,180097
"31-Jul-15","NHS","11H","Q65","Y57",199544,71972,271516,346951,90541,437492
"31-Jul-15","NHS","11J","Q70","Y57",323379,97355,420734,614178,140285,754463
"31-Jul-15","NHS","11M","Q64","Y57",196381,83249,279630,482920,122734,605654
"31-Jul-15","NHS","11N","Q66","Y57",237959,73324,311283,438977,104593,543570
"31-Jul-15","NHS","11T","Q65","Y57",86756,31142,117898,163910,42225,206135
"31-Jul-15","NHS","11X","Q65","Y57",248078,78019,326097,429382,108722,538104
"31-Jul-15","NHS","12A","Q65","Y57",114610,35954,150564,212159,56948,269107
"31-Jul-15","NHS","12D","Q64","Y57",77177,30367,107544,170073,49251,219324
"31-Jul-15","NHS","12F","Q44","Y54",155397,49636,205033,252839,67456,320295
"31-Jul-15","NHS","13P","Q54","Y55",261611,117398,379009,539961,185414,725375
"31-Jul-15","NHS","13T","Q49","Y54",228787,71665,300452,391253,95566,486819
"31-Jul-15","NHS","99A","Q48","Y54",187719,64061,251780,381379,89401,470780
"31-Jul-15","NHS","99C","Q49","Y54",90511,31394,121905,161678,40474,202152
"31-Jul-15","NHS","99D","Q59","Y55",60300,19351,79651,114396,28167,142563
"31-Jul-15","NHS","99E","Q57","Y55",109976,40236,150212,196629,56193,252822
"31-Jul-15","NHS","99F","Q57","Y55",62294,20131,82425,138632,33849,172481
"31-Jul-15","NHS","99G","Q57","Y55",80338,26586,106924,137929,37869,175798
"31-Jul-15","NHS","99H","Q68","Y57",86168,38516,124684,221273,63463,284736
"31-Jul-15","NHS","99J","Q67","Y57",125836,66390,192226,361230,106268,467498
"31-Jul-15","NHS","99K","Q68","Y57",67599,22531,90130,134256,34856,169112
"31-Jul-15","NHS","99M","Q70","Y57",80854,29736,110590,160778,46769,207547
"31-Jul-15","NHS","99N","Q64","Y57",169428,63987,233415,376198,103436,479634
"31-Jul-15","NHS","99P","Q66","Y57",384605,121099,505704,707716,166593,874309
"31-Jul-15","NHS","99Q","Q66","Y57",129622,38854,168476,223823,51170,274993
"31-Jul-15","NHS","UnA",0,0,131953,45438,177391,0,0,0
"31-Aug-15","NHS","00C","Q45","Y54",50210,17798,68008,82637,22759,105396
"31-Aug-15","NHS","00D","Q45","Y54",121802,37341,159143,217698,55205,272903
"31-Aug-15","NHS","00J","Q45","Y54",101742,30666,132408,198042,45012,243054
"31-Aug-15","NHS","00K","Q45","Y54",132948,46866,179814,223398,62463,285861
"31-Aug-15","NHS","00L","Q49","Y54",141059,41797,182856,255418,60388,315806
"31-Aug-15","NHS","00M","Q45","Y54",139735,46833,186568,214691,59193,273884
"31-Aug-15","NHS","00N","Q49","Y54",80925,22991,103916,119084,29442,148526
"31-Aug-15","NHS","00P","Q49","Y54",136992,43280,180272,221536,54544,276080
"31-Aug-15","NHS","00Q","Q47","Y54",58527,29793,88320,108833,38536,147369
"31-Aug-15","NHS","00R","Q47","Y54",63085,19116,82201,112370,29030,141400
"31-Aug-15","NHS","00T","Q46","Y54",108472,47273,155745,214210,65847,280057
"31-Aug-15","NHS","00V","Q46","Y54",76683,29941,106624,144168,42359,186527
"31-Aug-15","NHS","00W","Q46","Y54",73607,35822,109429,140813,41410,182223
"31-Aug-15","NHS","00X","Q47","Y54",73880,27726,101606,133938,35553,169491
"31-Aug-15","NHS","00Y","Q46","Y54",100856,42307,143163,170144,57168,227312
"31-Aug-15","NHS","01A","Q47","Y54",158951,62813,221764,288807,83535,372342
"31-Aug-15","NHS","01C","Q44","Y54",101709,33530,135239,156939,38558,195497
"31-Aug-15","NHS","01D","Q46","Y54",92252,37799,130051,161558,50562,212120
"31-Aug-15","NHS","01E","Q47","Y54",69414,27522,96936,159213,42463,201676
"31-Aug-15","NHS","01F","Q48","Y54",53139,17486,70625,97818,28152,125970
"31-Aug-15","NHS","01G","Q46","Y54",109237,42496,151733,186744,52269,239013
"31-Aug-15","NHS","01H","Q49","Y54",200704,67083,267787,409076,95062,504138
"31-Aug-15","NHS","01J","Q48","Y54",67820,23289,91109,113703,32383,146086
"31-Aug-15","NHS","01K","Q47","Y54",60948,19894,80842,129492,29964,159456
"31-Aug-15","NHS","01M","Q46","Y54",82527,29504,112031,132730,37922,170652
"31-Aug-15","NHS","01N","Q46","Y54",55644,21244,76888,128066,33476,161542
"31-Aug-15","NHS","01R","Q44","Y54",80624,27269,107893,140838,36372,177210
"31-Aug-15","NHS","01T","Q48","Y54",78778,22560,101338,126858,32014,158872
"31-Aug-15","NHS","01V","Q48","Y54",71680,19309,90989,92788,21547,114335
"31-Aug-15","NHS","01W","Q46","Y54",140238,45382,185620,224011,61021,285032
"31-Aug-15","NHS","01X","Q48","Y54",90935,29001,119936,139950,36271,176221
"31-Aug-15","NHS","01Y","Q46","Y54",113541,40664,154205,197934,55743,253677
"31-Aug-15","NHS","02A","Q46","Y54",97109,39877,136986,177254,52925,230179
"31-Aug-15","NHS","02D","Q44","Y54",42259,16312,58571,80153,21875,102028
"31-Aug-15","NHS","02E","Q44","Y54",92508,31181,123689,160810,44299,205109
"31-Aug-15","NHS","02F","Q44","Y54",126762,40115,166877,184750,44248,228998
"31-Aug-15","NHS","02G","Q47","Y54",44430,16407,60837,88957,22357,111314
"31-Aug-15","NHS","02H","Q46","Y54",151828,51150,202978,251917,67773,319690
"31-Aug-15","NHS","02M","Q47","Y54",83334,22337,105671,135694,30103,165797
"31-Aug-15","NHS","02N","Q52","Y54",65453,23422,88875,123814,34662,158476
"31-Aug-15","NHS","02P","Q51","Y54",120148,38407,158555,186297,49460,235757
"31-Aug-15","NHS","02Q","Q51","Y54",54360,16193,70553,90737,22917,113654
"31-Aug-15","NHS","02R","Q52","Y54",112881,48958,161839,247194,87432,334626
"31-Aug-15","NHS","02T","Q52","Y54",94417,34915,129332,160676,45679,206355
"31-Aug-15","NHS","02V","Q52","Y54",96523,33805,130328,157266,42678,199944
"31-Aug-15","NHS","02W","Q52","Y54",46836,27375,74211,57079,25660,82739
"31-Aug-15","NHS","02X","Q51","Y54",166025,51458,217483,238646,64976,303622
"31-Aug-15","NHS","02Y","Q50","Y54",116395,35942,152337,255311,59249,314560
"31-Aug-15","NHS","03A","Q52","Y54",103205,38371,141576,188691,51708,240399
"31-Aug-15","NHS","03C","Q52","Y54",126430,42547,168977,260312,60186,320498
"31-Aug-15","NHS","03D","Q50","Y54",61921,21099,83020,124990,28648,153638
"31-Aug-15","NHS","03E","Q50","Y54",58461,21952,80413,124886,33363,158249
"31-Aug-15","NHS","03F","Q50","Y54",159643,51474,211117,202325,55264,257589
"31-Aug-15","NHS","03G","Q52","Y54",105594,41442,147036,185330,55709,241039
"31-Aug-15","NHS","03H","Q50","Y54",75376,23845,99221,125404,34423,159827
"31-Aug-15","NHS","03J","Q52","Y54",83760,36161,119921,141619,46261,187880
"31-Aug-15","NHS","03K","Q50","Y54",61705,21486,83191,133409,35351,168760
"31-Aug-15","NHS","03L","Q51","Y54",122715,40949,163664,202588,56101,258689
"31-Aug-15","NHS","03M","Q50","Y54",43177,13891,57068,89607,20529,110136
"31-Aug-15","NHS","03N","Q51","Y54",265142,86828,351970,445431,114654,560085
"31-Aug-15","NHS","03Q","Q50","Y54",153041,46141,199182,283313,65753,349066
"31-Aug-15","NHS","03R","Q52","Y54",170307,52951,223258,260843,68865,329708
"31-Aug-15","NHS","03T","Q59","Y55",95166,25312,120478,187036,42388,229424
"31-Aug-15","NHS","03V","Q58","Y55",27119,9847,36966,49002,15210,64212
"31-Aug-15","NHS","03W","Q59","Y55",116916,43218,160134,255340,66582,321922
"31-Aug-15","NHS","03X","Q55","Y55",54361,14774,69135,75345,19585,94930
"31-Aug-15","NHS","03Y","Q55","Y55",40977,12365,53342,87499,21751,109250
"31-Aug-15","NHS","04C","Q59","Y55",141350,63305,204655,254324,79488,333812
"31-Aug-15","NHS","04D","Q59","Y55",95645,30345,125990,185088,44536,229624
"31-Aug-15","NHS","04E","Q55","Y55",89772,29795,119567,153265,40641,193906
"31-Aug-15","NHS","04F","Q58","Y55",84106,44810,128916,196095,65262,261357
"31-Aug-15","NHS","04G","Q58","Y55",255841,95110,350951,486324,140251,626575
"31-Aug-15","NHS","04H","Q55","Y55",43778,14917,58695,93050,23903,116953
"31-Aug-15","NHS","04J","Q55","Y55",123492,40674,164166,220313,51843,272156
"31-Aug-15","NHS","04K","Q55","Y55",144560,51429,195989,246983,63854,310837
"31-Aug-15","NHS","04L","Q55","Y55",79443,24944,104387,117304,30321,147625
"31-Aug-15","NHS","04M","Q55","Y55",42448,13352,55800,89783,21460,111243
"31-Aug-15","NHS","04N","Q55","Y55",37233,16120,53353,89437,23398,112835
"31-Aug-15","NHS","04Q","Q59","Y55",40049,15227,55276,97208,25634,122842
"31-Aug-15","NHS","04R","Q55","Y55",165525,63828,229353,405788,112379,518167
"31-Aug-15","NHS","04V","Q59","Y55",156374,53244,209618,301417,75842,377259
"31-Aug-15","NHS","04X","Q54","Y55",100195,37319,137514,151704,49451,201155
"31-Aug-15","NHS","04Y","Q60","Y55",51583,15846,67429,106089,27498,133587
"31-Aug-15","NHS","05A","Q53","Y55",179089,64184,243273,335514,95669,431183
"31-Aug-15","NHS","05C","Q54","Y55",128242,38245,166487,246783,67644,314427
"31-Aug-15","NHS","05D","Q60","Y55",55802,22884,78686,97566,27012,124578
"31-Aug-15","NHS","05F","Q53","Y55",74964,24100,99064,150027,36060,186087
"31-Aug-15","NHS","05G","Q60","Y55",86061,27557,113618,173683,40758,214441
"31-Aug-15","NHS","05H","Q53","Y55",86010,28334,114344,148583,39544,188127
"31-Aug-15","NHS","05J","Q53","Y55",71717,26161,97878,141371,37894,179265
"31-Aug-15","NHS","05L","Q54","Y55",208367,79799,288166,358104,122025,480129
"31-Aug-15","NHS","05N","Q60","Y55",120609,41110,161719,248550,60017,308567
"31-Aug-15","NHS","05P","Q54","Y55",73399,28027,101426,163587,45274,208861
"31-Aug-15","NHS","05Q","Q60","Y55",98640,32722,131362,179641,44842,224483
"31-Aug-15","NHS","05R","Q53","Y55",116980,37521,154501,209336,49893,259229
"31-Aug-15","NHS","05T","Q53","Y55",117755,39697,157452,236565,57917,294482
"31-Aug-15","NHS","05V","Q60","Y55",55957,18182,74139,122990,28715,151705
"31-Aug-15","NHS","05W","Q60","Y55",127160,45261,172421,201959,56481,258440
"31-Aug-15","NHS","05X","Q60","Y55",76243,29525,105768,129499,38953,168452
"31-Aug-15","NHS","05Y","Q54","Y55",100641,41826,142467,208276,63885,272161
"31-Aug-15","NHS","06A","Q54","Y55",98060,34420,132480,194708,56849,251557
"31-Aug-15","NHS","06D","Q53","Y55",33864,13728,47592,79270,19151,98421
"31-Aug-15","NHS","06F","Q58","Y55",172469,66966,239435,331145,94765,425910
"31-Aug-15","NHS","06H","Q56","Y55",311305,122447,433752,671453,183539,854992
"31-Aug-15","NHS","06K","Q58","Y55",244891,91514,336405,425601,120649,546250
"31-Aug-15","NHS","06L","Q56","Y55",164076,54362,218438,313699,82449,396148
"31-Aug-15","NHS","06M","Q56","Y55",128763,32217,160980,171450,42308,213758
"31-Aug-15","NHS","06N","Q58","Y55",219281,98494,317775,441948,133844,575792
"31-Aug-15","NHS","06P","Q58","Y55",79249,34525,113774,154310,53679,207989
"31-Aug-15","NHS","06Q","Q57","Y55",172725,54983,227708,301090,80440,381530
"31-Aug-15","NHS","06T","Q57","Y55",138064,44363,182427,253628,62719,316347
"31-Aug-15","NHS","06V","Q56","Y55",65624,16574,82198,138831,29632,168463
"31-Aug-15","NHS","06W","Q56","Y55",125560,34034,159594,159019,35953,194972
"31-Aug-15","NHS","06Y","Q56","Y55",105001,30010,135011,188892,48538,237430
"31-Aug-15","NHS","07G","Q57","Y55",50119,22714,72833,121434,39415,160849
"31-Aug-15","NHS","07H","Q57","Y55",90441,34193,124634,228188,65037,293225
"31-Aug-15","NHS","07J","Q56","Y55",58028,16275,74303,138857,32628,171485
"31-Aug-15","NHS","07K","Q56","Y55",103904,34723,138627,177643,46145,223788
"31-Aug-15","NHS","07L","Q71","Y56",75038,34009,109047,136747,57605,194352
"31-Aug-15","NHS","07M","Q71","Y56",102396,49609,152005,282465,86623,369088
"31-Aug-15","NHS","07N","Q71","Y56",75853,34693,110546,181780,54907,236687
"31-Aug-15","NHS","07P","Q71","Y56",119582,48436,168018,244716,72548,317264
"31-Aug-15","NHS","07Q","Q71","Y56",92645,49896,142541,247450,70449,317899
"31-Aug-15","NHS","07R","Q71","Y56",97953,29214,127167,187334,42385,229719
"31-Aug-15","NHS","07T","Q71","Y56",77874,26538,104412,205220,59807,265027
"31-Aug-15","NHS","07V","Q71","Y56",133154,56954,190108,281124,91628,372752
"31-Aug-15","NHS","07W","Q71","Y56",140961,58063,199024,262978,79516,342494
"31-Aug-15","NHS","07X","Q71","Y56",113849,50165,164014,239600,80924,320524
"31-Aug-15","NHS","07Y","Q71","Y56",106549,43893,150442,201963,60444,262407
"31-Aug-15","NHS","08A","Q71","Y56",107103,48306,155409,200318,63690,264008
"31-Aug-15","NHS","08C","Q71","Y56",76116,21908,98024,145357,33328,178685
"31-Aug-15","NHS","08D","Q71","Y56",113500,46869,160369,204425,58961,263386
"31-Aug-15","NHS","08E","Q71","Y56",78483,33453,111936,187629,55743,243372
"31-Aug-15","NHS","08F","Q71","Y56",94566,34676,129242,189960,52120,242080
"31-Aug-15","NHS","08G","Q71","Y56",87955,39342,127297,219259,67547,286806
"31-Aug-15","NHS","08H","Q71","Y56",80668,22527,103195,177322,38345,215667
"31-Aug-15","NHS","08J","Q71","Y56",61781,26949,88730,131100,35693,166793
"31-Aug-15","NHS","08K","Q71","Y56",137955,41008,178963,252274,61968,314242
"31-Aug-15","NHS","08L","Q71","Y56",121272,42291,163563,220491,65689,286180
"31-Aug-15","NHS","08M","Q71","Y56",93666,48198,141864,237000,81227,318227
"31-Aug-15","NHS","08N","Q71","Y56",113152,53558,166710,215220,73052,288272
"31-Aug-15","NHS","08P","Q71","Y56",47289,24402,71691,148509,42856,191365
"31-Aug-15","NHS","08Q","Q71","Y56",107953,36912,144865,237369,61095,298464
"31-Aug-15","NHS","08R","Q71","Y56",71203,23638,94841,158248,44975,203223
"31-Aug-15","NHS","08T","Q71","Y56",67135,30190,97325,151229,44685,195914
"31-Aug-15","NHS","08V","Q71","Y56",81887,31087,112974,212378,60512,272890
"31-Aug-15","NHS","08W","Q71","Y56",84258,35081,119339,202000,63797,265797
"31-Aug-15","NHS","08X","Q71","Y56",107305,38720,146025,252281,58235,310516
"31-Aug-15","NHS","08Y","Q71","Y56",82802,22179,104981,180239,39512,219751
"31-Aug-15","NHS","09A","Q71","Y56",59848,13519,73367,135765,26919,162684
"31-Aug-15","NHS","09C","Q67","Y57",44651,18759,63410,93288,28435,121723
"31-Aug-15","NHS","09D","Q68","Y57",107096,36815,143911,227451,50661,278112
"31-Aug-15","NHS","09E","Q67","Y57",71408,28750,100158,163771,38618,202389
"31-Aug-15","NHS","09F","Q68","Y57",69874,21828,91702,148747,34735,183482
"31-Aug-15","NHS","09G","Q68","Y57",175726,60566,236292,389667,90518,480185
"31-Aug-15","NHS","09H","Q68","Y57",50074,20315,70389,83450,25521,108971
"31-Aug-15","NHS","09J","Q67","Y57",78254,33334,111588,195263,56614,251877
"31-Aug-15","NHS","09L","Q68","Y57",63831,27559,91390,137822,40091,177913
"31-Aug-15","NHS","09N","Q68","Y57",61986,29690,91676,163414,44358,207772
"31-Aug-15","NHS","09P","Q68","Y57",80467,22114,102581,146503,35305,181808
"31-Aug-15","NHS","09W","Q67","Y57",116834,50381,167215,209266,61839,271105
"31-Aug-15","NHS","09X","Q68","Y57",98444,41853,140297,175516,49806,225322
"31-Aug-15","NHS","09Y","Q68","Y57",101097,51002,152099,265796,74403,340199
"31-Aug-15","NHS","10A","Q67","Y57",79971,26890,106861,162461,41157,203618
"31-Aug-15","NHS","10C","Q68","Y57",21349,12880,34229,74002,20395,94397
"31-Aug-15","NHS","10D","Q67","Y57",33659,14620,48279,84309,25332,109641
"31-Aug-15","NHS","10E","Q67","Y57",52185,16365,68550,107152,29614,136766
"31-Aug-15","NHS","10G","Q69","Y57",55895,23375,79270,102485,31874,134359
"31-Aug-15","NHS","10H","Q69","Y57",97965,46321,144286,246305,73137,319442
"31-Aug-15","NHS","10J","Q70","Y57",84551,32925,117476,168966,48845,217811
"31-Aug-15","NHS","10K","Q70","Y57",75304,27314,102618,156661,40456,197117
"31-Aug-15","NHS","10L","Q70","Y57",60440,17569,78009,112702,25691,138393
"31-Aug-15","NHS","10M","Q69","Y57",42107,16986,59093,81354,24358,105712
"31-Aug-15","NHS","10N","Q69","Y57",14303,10475,24778,76712,23195,99907
"31-Aug-15","NHS","10Q","Q69","Y57",259589,103943,363532,515117,137206,652323
"31-Aug-15","NHS","10R","Q70","Y57",87288,29731,117019,164660,42800,207460
"31-Aug-15","NHS","10T","Q69","Y57",50447,25001,75448,104010,39014,143024
"31-Aug-15","NHS","10V","Q70","Y57",73344,27860,101204,166327,43567,209894
"31-Aug-15","NHS","10W","Q69","Y57",59294,24411,83705,85769,23251,109020
"31-Aug-15","NHS","10X","Q70","Y57",102164,34095,136259,194254,47887,242141
"31-Aug-15","NHS","10Y","Q69","Y57",58444,28168,86612,154056,45405,199461
"31-Aug-15","NHS","11A","Q70","Y57",222076,76869,298945,436487,111527,548014
"31-Aug-15","NHS","11C","Q69","Y57",42308,19829,62137,109699,30166,139865
"31-Aug-15","NHS","11D","Q69","Y57",48600,22862,71462,121369,36497,157866
"31-Aug-15","NHS","11E","Q64","Y57",75121,28065,103186,145883,34214,180097
"31-Aug-15","NHS","11H","Q65","Y57",199216,72150,271366,346951,90541,437492
"31-Aug-15","NHS","11J","Q70","Y57",323132,97231,420363,614178,140285,754463
"31-Aug-15","NHS","11M","Q64","Y57",196377,83308,279685,482920,122734,605654
"31-Aug-15","NHS","11N","Q66","Y57",238007,73326,311333,438977,104593,543570
"31-Aug-15","NHS","11T","Q65","Y57",86706,31192,117898,163910,42225,206135
"31-Aug-15","NHS","11X","Q65","Y57",248127,78059,326186,429382,108722,538104
"31-Aug-15","NHS","12A","Q65","Y57",114730,35934,150664,212159,56948,269107
"31-Aug-15","NHS","12D","Q64","Y57",76985,30458,107443,170073,49251,219324
"31-Aug-15","NHS","12F","Q44","Y54",155297,49553,204850,252839,67456,320295
"31-Aug-15","NHS","13P","Q54","Y55",261900,117643,379543,539961,185414,725375
"31-Aug-15","NHS","13T","Q49","Y54",229089,71930,301019,391253,95566,486819
"31-Aug-15","NHS","99A","Q48","Y54",187527,64177,251704,381379,89401,470780
"31-Aug-15","NHS","99C","Q49","Y54",90484,31365,121849,161678,40474,202152
"31-Aug-15","NHS","99D","Q59","Y55",60210,19405,79615,114396,28167,142563
"31-Aug-15","NHS","99E","Q57","Y55",110106,40353,150459,196629,56193,252822
"31-Aug-15","NHS","99F","Q57","Y55",62584,20166,82750,138632,33849,172481
"31-Aug-15","NHS","99G","Q57","Y55",80387,26521,106908,137929,37869,175798
"31-Aug-15","NHS","99H","Q68","Y57",86086,38635,124721,221273,63463,284736
"31-Aug-15","NHS","99J","Q67","Y57",125793,66448,192241,361230,106268,467498
"31-Aug-15","NHS","99K","Q68","Y57",67641,22616,90257,134256,34856,169112
"31-Aug-15","NHS","99M","Q70","Y57",80796,29696,110492,160778,46769,207547
"31-Aug-15","NHS","99N","Q64","Y57",169362,63912,233274,376198,103436,479634
"31-Aug-15","NHS","99P","Q66","Y57",384678,121106,505784,707716,166593,874309
"31-Aug-15","NHS","99Q","Q66","Y57",129683,38834,168517,223823,51170,274993
"31-Aug-15","NHS","UnA",0,0,131604,45359,176963,0,0,0
"30-Sep-15","NHS","00C","Q45","Y54",50259,17826,68085,82637,22759,105396
"30-Sep-15","NHS","00D","Q45","Y54",121821,37325,159146,217698,55205,272903
"30-Sep-15","NHS","00J","Q45","Y54",101813,30635,132448,198042,45012,243054
"30-Sep-15","NHS","00K","Q45","Y54",133106,46886,179992,223398,62463,285861
"30-Sep-15","NHS","00L","Q49","Y54",141041,41779,182820,255418,60388,315806
"30-Sep-15","NHS","00M","Q45","Y54",139745,46819,186564,214691,59193,273884
"30-Sep-15","NHS","00N","Q49","Y54",80979,22913,103892,119084,29442,148526
"30-Sep-15","NHS","00P","Q49","Y54",136651,43285,179936,221536,54544,276080
"30-Sep-15","NHS","00Q","Q47","Y54",58495,29742,88237,108833,38536,147369
"30-Sep-15","NHS","00R","Q47","Y54",63106,19086,82192,112370,29030,141400
"30-Sep-15","NHS","00T","Q46","Y54",108104,47190,155294,214210,65847,280057
"30-Sep-15","NHS","00V","Q46","Y54",76731,29917,106648,144168,42359,186527
"30-Sep-15","NHS","00W","Q46","Y54",73597,35938,109535,140813,41410,182223
"30-Sep-15","NHS","00X","Q47","Y54",74070,27781,101851,133938,35553,169491
"30-Sep-15","NHS","00Y","Q46","Y54",100776,42328,143104,170144,57168,227312
"30-Sep-15","NHS","01A","Q47","Y54",159018,62840,221858,288807,83535,372342
"30-Sep-15","NHS","01C","Q44","Y54",101490,33478,134968,156939,38558,195497
"30-Sep-15","NHS","01D","Q46","Y54",92025,37737,129762,161558,50562,212120
"30-Sep-15","NHS","01E","Q47","Y54",69206,27490,96696,159213,42463,201676
"30-Sep-15","NHS","01F","Q48","Y54",53203,17545,70748,97818,28152,125970
"30-Sep-15","NHS","01G","Q46","Y54",109123,42390,151513,186744,52269,239013
"30-Sep-15","NHS","01H","Q49","Y54",200453,67059,267512,409076,95062,504138
"30-Sep-15","NHS","01J","Q48","Y54",67935,23219,91154,113703,32383,146086
"30-Sep-15","NHS","01K","Q47","Y54",60696,19790,80486,129492,29964,159456
"30-Sep-15","NHS","01M","Q46","Y54",82680,29550,112230,132730,37922,170652
"30-Sep-15","NHS","01N","Q46","Y54",55565,21262,76827,128066,33476,161542
"30-Sep-15","NHS","01R","Q44","Y54",80504,27232,107736,140838,36372,177210
"30-Sep-15","NHS","01T","Q48","Y54",78975,22506,101481,126858,32014,158872
"30-Sep-15","NHS","01V","Q48","Y54",71628,19324,90952,92788,21547,114335
"30-Sep-15","NHS","01W","Q46","Y54",140069,45424,185493,224011,61021,285032
"30-Sep-15","NHS","01X","Q48","Y54",90977,29022,119999,139950,36271,176221
"30-Sep-15","NHS","01Y","Q46","Y54",113362,40516,153878,197934,55743,253677
"30-Sep-15","NHS","02A","Q46","Y54",97120,39897,137017,177254,52925,230179
"30-Sep-15","NHS","02D","Q44","Y54",42389,16283,58672,80153,21875,102028
"30-Sep-15","NHS","02E","Q44","Y54",92620,31244,123864,160810,44299,205109
"30-Sep-15","NHS","02F","Q44","Y54",126750,40066,166816,184750,44248,228998
"30-Sep-15","NHS","02G","Q47","Y54",44419,16390,60809,88957,22357,111314
"30-Sep-15","NHS","02H","Q46","Y54",152132,51175,203307,251917,67773,319690
"30-Sep-15","NHS","02M","Q47","Y54",83141,22293,105434,135694,30103,165797
"30-Sep-15","NHS","02N","Q52","Y54",65611,23464,89075,123814,34662,158476
"30-Sep-15","NHS","02P","Q51","Y54",120286,38429,158715,186297,49460,235757
"30-Sep-15","NHS","02Q","Q51","Y54",54454,16197,70651,90737,22917,113654
"30-Sep-15","NHS","02R","Q52","Y54",112744,48999,161743,247194,87432,334626
"30-Sep-15","NHS","02T","Q52","Y54",94167,34785,128952,160676,45679,206355
"30-Sep-15","NHS","02V","Q52","Y54",96386,33897,130283,157266,42678,199944
"30-Sep-15","NHS","02W","Q52","Y54",46904,27423,74327,57079,25660,82739
"30-Sep-15","NHS","02X","Q51","Y54",166007,51500,217507,238646,64976,303622
"30-Sep-15","NHS","02Y","Q50","Y54",116298,35946,152244,255311,59249,314560
"30-Sep-15","NHS","03A","Q52","Y54",102809,38265,141074,188691,51708,240399
"30-Sep-15","NHS","03C","Q52","Y54",126409,42579,168988,260312,60186,320498
"30-Sep-15","NHS","03D","Q50","Y54",61648,21081,82729,124990,28648,153638
"30-Sep-15","NHS","03E","Q50","Y54",58376,21929,80305,124886,33363,158249
"30-Sep-15","NHS","03F","Q50","Y54",159797,51503,211300,202325,55264,257589
"30-Sep-15","NHS","03G","Q52","Y54",105611,41668,147279,185330,55709,241039
"30-Sep-15","NHS","03H","Q50","Y54",75224,23898,99122,125404,34423,159827
"30-Sep-15","NHS","03J","Q52","Y54",83875,36230,120105,141619,46261,187880
"30-Sep-15","NHS","03K","Q50","Y54",61606,21389,82995,133409,35351,168760
"30-Sep-15","NHS","03L","Q51","Y54",122630,40884,163514,202588,56101,258689
"30-Sep-15","NHS","03M","Q50","Y54",42921,13799,56720,89607,20529,110136
"30-Sep-15","NHS","03N","Q51","Y54",265180,86864,352044,445431,114654,560085
"30-Sep-15","NHS","03Q","Q50","Y54",152729,46046,198775,283313,65753,349066
"30-Sep-15","NHS","03R","Q52","Y54",170118,52961,223079,260843,68865,329708
"30-Sep-15","NHS","03T","Q59","Y55",95279,25389,120668,187036,42388,229424
"30-Sep-15","NHS","03V","Q58","Y55",27142,9831,36973,49002,15210,64212
"30-Sep-15","NHS","03W","Q59","Y55",116764,43242,160006,255340,66582,321922
"30-Sep-15","NHS","03X","Q55","Y55",54248,14741,68989,75345,19585,94930
"30-Sep-15","NHS","03Y","Q55","Y55",40797,12337,53134,87499,21751,109250
"30-Sep-15","NHS","04C","Q59","Y55",141685,63432,205117,254324,79488,333812
"30-Sep-15","NHS","04D","Q59","Y55",95339,30202,125541,185088,44536,229624
"30-Sep-15","NHS","04E","Q55","Y55",89685,29798,119483,153265,40641,193906
"30-Sep-15","NHS","04F","Q58","Y55",83623,44718,128341,196095,65262,261357
"30-Sep-15","NHS","04G","Q58","Y55",255469,95079,350548,486324,140251,626575
"30-Sep-15","NHS","04H","Q55","Y55",43824,14896,58720,93050,23903,116953
"30-Sep-15","NHS","04J","Q55","Y55",123408,40616,164024,220313,51843,272156
"30-Sep-15","NHS","04K","Q55","Y55",144019,51275,195294,246983,63854,310837
"30-Sep-15","NHS","04L","Q55","Y55",79241,24838,104079,117304,30321,147625
"30-Sep-15","NHS","04M","Q55","Y55",42279,13354,55633,89783,21460,111243
"30-Sep-15","NHS","04N","Q55","Y55",37126,16099,53225,89437,23398,112835
"30-Sep-15","NHS","04Q","Q59","Y55",39809,15181,54990,97208,25634,122842
"30-Sep-15","NHS","04R","Q55","Y55",165484,63936,229420,405788,112379,518167
"30-Sep-15","NHS","04V","Q59","Y55",156349,53264,209613,301417,75842,377259
"30-Sep-15","NHS","04X","Q54","Y55",99987,37435,137422,151704,49451,201155
"30-Sep-15","NHS","04Y","Q60","Y55",51478,15830,67308,106089,27498,133587
"30-Sep-15","NHS","05A","Q53","Y55",179158,64483,243641,335514,95669,431183
"30-Sep-15","NHS","05C","Q54","Y55",128266,38154,166420,246783,67644,314427
"30-Sep-15","NHS","05D","Q60","Y55",55602,22822,78424,97566,27012,124578
"30-Sep-15","NHS","05F","Q53","Y55",75025,24073,99098,150027,36060,186087
"30-Sep-15","NHS","05G","Q60","Y55",85964,27533,113497,173683,40758,214441
"30-Sep-15","NHS","05H","Q53","Y55",86303,28350,114653,148583,39544,188127
"30-Sep-15","NHS","05J","Q53","Y55",71758,26140,97898,141371,37894,179265
"30-Sep-15","NHS","05L","Q54","Y55",208698,80403,289101,358104,122025,480129
"30-Sep-15","NHS","05N","Q60","Y55",120605,41016,161621,248550,60017,308567
"30-Sep-15","NHS","05P","Q54","Y55",73245,28015,101260,163587,45274,208861
"30-Sep-15","NHS","05Q","Q60","Y55",98866,32763,131629,179641,44842,224483
"30-Sep-15","NHS","05R","Q53","Y55",116931,37540,154471,209336,49893,259229
"30-Sep-15","NHS","05T","Q53","Y55",117673,39664,157337,236565,57917,294482
"30-Sep-15","NHS","05V","Q60","Y55",56123,18289,74412,122990,28715,151705
"30-Sep-15","NHS","05W","Q60","Y55",127262,45254,172516,201959,56481,258440
"30-Sep-15","NHS","05X","Q60","Y55",76283,29597,105880,129499,38953,168452
"30-Sep-15","NHS","05Y","Q54","Y55",100528,41910,142438,208276,63885,272161
"30-Sep-15","NHS","06A","Q54","Y55",97933,34560,132493,194708,56849,251557
"30-Sep-15","NHS","06D","Q53","Y55",33803,13658,47461,79270,19151,98421
"30-Sep-15","NHS","06F","Q58","Y55",172483,67188,239671,331145,94765,425910
"30-Sep-15","NHS","06H","Q56","Y55",311188,122274,433462,671453,183539,854992
"30-Sep-15","NHS","06K","Q58","Y55",244747,91666,336413,425601,120649,546250
"30-Sep-15","NHS","06L","Q56","Y55",163915,54239,218154,313699,82449,396148
"30-Sep-15","NHS","06M","Q56","Y55",128698,32174,160872,171450,42308,213758
"30-Sep-15","NHS","06N","Q58","Y55",218847,98552,317399,441948,133844,575792
"30-Sep-15","NHS","06P","Q58","Y55",79301,34676,113977,154310,53679,207989
"30-Sep-15","NHS","06Q","Q57","Y55",172812,55006,227818,301090,80440,381530
"30-Sep-15","NHS","06T","Q57","Y55",137378,44222,181600,253628,62719,316347
"30-Sep-15","NHS","06V","Q56","Y55",65657,16615,82272,138831,29632,168463
"30-Sep-15","NHS","06W","Q56","Y55",125471,34054,159525,159019,35953,194972
"30-Sep-15","NHS","06Y","Q56","Y55",104868,29952,134820,188892,48538,237430
"30-Sep-15","NHS","07G","Q57","Y55",50014,22866,72880,121434,39415,160849
"30-Sep-15","NHS","07H","Q57","Y55",90358,34199,124557,228188,65037,293225
"30-Sep-15","NHS","07J","Q56","Y55",58038,16343,74381,138857,32628,171485
"30-Sep-15","NHS","07K","Q56","Y55",103839,34687,138526,177643,46145,223788
"30-Sep-15","NHS","07L","Q71","Y56",75139,34192,109331,136747,57605,194352
"30-Sep-15","NHS","07M","Q71","Y56",102209,49645,151854,282465,86623,369088
"30-Sep-15","NHS","07N","Q71","Y56",76018,34698,110716,181780,54907,236687
"30-Sep-15","NHS","07P","Q71","Y56",119236,48579,167815,244716,72548,317264
"30-Sep-15","NHS","07Q","Q71","Y56",92381,49959,142340,247450,70449,317899
"30-Sep-15","NHS","07R","Q71","Y56",98058,29269,127327,187334,42385,229719
"30-Sep-15","NHS","07T","Q71","Y56",77432,26470,103902,205220,59807,265027
"30-Sep-15","NHS","07V","Q71","Y56",133338,57079,190417,281124,91628,372752
"30-Sep-15","NHS","07W","Q71","Y56",140813,58317,199130,262978,79516,342494
"30-Sep-15","NHS","07X","Q71","Y56",113859,50388,164247,239600,80924,320524
"30-Sep-15","NHS","07Y","Q71","Y56",106704,44191,150895,201963,60444,262407
"30-Sep-15","NHS","08A","Q71","Y56",106681,48272,154953,200318,63690,264008
"30-Sep-15","NHS","08C","Q71","Y56",76115,21966,98081,145357,33328,178685
"30-Sep-15","NHS","08D","Q71","Y56",113376,46968,160344,204425,58961,263386
"30-Sep-15","NHS","08E","Q71","Y56",78269,33505,111774,187629,55743,243372
"30-Sep-15","NHS","08F","Q71","Y56",94701,34758,129459,189960,52120,242080
"30-Sep-15","NHS","08G","Q71","Y56",87770,39395,127165,219259,67547,286806
"30-Sep-15","NHS","08H","Q71","Y56",80889,22724,103613,177322,38345,215667
"30-Sep-15","NHS","08J","Q71","Y56",61802,26984,88786,131100,35693,166793
"30-Sep-15","NHS","08K","Q71","Y56",137776,41037,178813,252274,61968,314242
"30-Sep-15","NHS","08L","Q71","Y56",121523,42495,164018,220491,65689,286180
"30-Sep-15","NHS","08M","Q71","Y56",93350,48328,141678,237000,81227,318227
"30-Sep-15","NHS","08N","Q71","Y56",112837,53639,166476,215220,73052,288272
"30-Sep-15","NHS","08P","Q71","Y56",47401,24423,71824,148509,42856,191365
"30-Sep-15","NHS","08Q","Q71","Y56",107881,36983,144864,237369,61095,298464
"30-Sep-15","NHS","08R","Q71","Y56",71132,23773,94905,158248,44975,203223
"30-Sep-15","NHS","08T","Q71","Y56",67290,30442,97732,151229,44685,195914
"30-Sep-15","NHS","08V","Q71","Y56",81671,31139,112810,212378,60512,272890
"30-Sep-15","NHS","08W","Q71","Y56",84232,35114,119346,202000,63797,265797
"30-Sep-15","NHS","08X","Q71","Y56",107217,38923,146140,252281,58235,310516
"30-Sep-15","NHS","08Y","Q71","Y56",83060,22279,105339,180239,39512,219751
"30-Sep-15","NHS","09A","Q71","Y56",59830,13512,73342,135765,26919,162684
"30-Sep-15","NHS","09C","Q67","Y57",44655,18750,63405,93288,28435,121723
"30-Sep-15","NHS","09D","Q68","Y57",107008,36822,143830,227451,50661,278112
"30-Sep-15","NHS","09E","Q67","Y57",71319,28728,100047,163771,38618,202389
"30-Sep-15","NHS","09F","Q68","Y57",69690,21772,91462,148747,34735,183482
"30-Sep-15","NHS","09G","Q68","Y57",175483,60534,236017,389667,90518,480185
"30-Sep-15","NHS","09H","Q68","Y57",49925,20350,70275,83450,25521,108971
"30-Sep-15","NHS","09J","Q67","Y57",78351,33350,111701,195263,56614,251877
"30-Sep-15","NHS","09L","Q68","Y57",63754,27613,91367,137822,40091,177913
"30-Sep-15","NHS","09N","Q68","Y57",61657,29712,91369,163414,44358,207772
"30-Sep-15","NHS","09P","Q68","Y57",80493,22144,102637,146503,35305,181808
"30-Sep-15","NHS","09W","Q67","Y57",116782,50507,167289,209266,61839,271105
"30-Sep-15","NHS","09X","Q68","Y57",98456,41921,140377,175516,49806,225322
"30-Sep-15","NHS","09Y","Q68","Y57",101093,51176,152269,265796,74403,340199
"30-Sep-15","NHS","10A","Q67","Y57",79901,26935,106836,162461,41157,203618
"30-Sep-15","NHS","10C","Q68","Y57",21252,12952,34204,74002,20395,94397
"30-Sep-15","NHS","10D","Q67","Y57",33677,14612,48289,84309,25332,109641
"30-Sep-15","NHS","10E","Q67","Y57",52263,16331,68594,107152,29614,136766
"30-Sep-15","NHS","10G","Q69","Y57",55905,23374,79279,102485,31874,134359
"30-Sep-15","NHS","10H","Q69","Y57",97896,46359,144255,246305,73137,319442
"30-Sep-15","NHS","10J","Q70","Y57",84762,32899,117661,168966,48845,217811
"30-Sep-15","NHS","10K","Q70","Y57",75233,27277,102510,156661,40456,197117
"30-Sep-15","NHS","10L","Q70","Y57",60352,17492,77844,112702,25691,138393
"30-Sep-15","NHS","10M","Q69","Y57",42156,16968,59124,81354,24358,105712
"30-Sep-15","NHS","10N","Q69","Y57",14196,10436,24632,76712,23195,99907
"30-Sep-15","NHS","10Q","Q69","Y57",259275,104025,363300,515117,137206,652323
"30-Sep-15","NHS","10R","Q70","Y57",87200,29722,116922,164660,42800,207460
"30-Sep-15","NHS","10T","Q69","Y57",50410,24952,75362,104010,39014,143024
"30-Sep-15","NHS","10V","Q70","Y57",73303,27833,101136,166327,43567,209894
"30-Sep-15","NHS","10W","Q69","Y57",59458,24444,83902,85769,23251,109020
"30-Sep-15","NHS","10X","Q70","Y57",102055,34146,136201,194254,47887,242141
"30-Sep-15","NHS","10Y","Q69","Y57",58603,28127,86730,154056,45405,199461
"30-Sep-15","NHS","11A","Q70","Y57",222281,76943,299224,436487,111527,548014
"30-Sep-15","NHS","11C","Q69","Y57",42124,19893,62017,109699,30166,139865
"30-Sep-15","NHS","11D","Q69","Y57",48636,22882,71518,121369,36497,157866
"30-Sep-15","NHS","11E","Q64","Y57",75050,28065,103115,145883,34214,180097
"30-Sep-15","NHS","11H","Q65","Y57",199341,72306,271647,346951,90541,437492
"30-Sep-15","NHS","11J","Q70","Y57",323122,97257,420379,614178,140285,754463
"30-Sep-15","NHS","11M","Q64","Y57",196642,83419,280061,482920,122734,605654
"30-Sep-15","NHS","11N","Q66","Y57",237892,73370,311262,438977,104593,543570
"30-Sep-15","NHS","11T","Q65","Y57",86515,31190,117705,163910,42225,206135
"30-Sep-15","NHS","11X","Q65","Y57",248553,78021,326574,429382,108722,538104
"30-Sep-15","NHS","12A","Q65","Y57",115012,35907,150919,212159,56948,269107
"30-Sep-15","NHS","12D","Q64","Y57",76955,30421,107376,170073,49251,219324
"30-Sep-15","NHS","12F","Q44","Y54",155160,49542,204702,252839,67456,320295
"30-Sep-15","NHS","13P","Q54","Y55",261501,117842,379343,539961,185414,725375
"30-Sep-15","NHS","13T","Q49","Y54",229154,72220,301374,391253,95566,486819
"30-Sep-15","NHS","99A","Q48","Y54",187411,64322,251733,381379,89401,470780
"30-Sep-15","NHS","99C","Q49","Y54",90530,31427,121957,161678,40474,202152
"30-Sep-15","NHS","99D","Q59","Y55",60074,19372,79446,114396,28167,142563
"30-Sep-15","NHS","99E","Q57","Y55",110389,40454,150843,196629,56193,252822
"30-Sep-15","NHS","99F","Q57","Y55",62683,20158,82841,138632,33849,172481
"30-Sep-15","NHS","99G","Q57","Y55",80392,26465,106857,137929,37869,175798
"30-Sep-15","NHS","99H","Q68","Y57",86140,38694,124834,221273,63463,284736
"30-Sep-15","NHS","99J","Q67","Y57",125829,66403,192232,361230,106268,467498
"30-Sep-15","NHS","99K","Q68","Y57",67622,22616,90238,134256,34856,169112
"30-Sep-15","NHS","99M","Q70","Y57",80885,29670,110555,160778,46769,207547
"30-Sep-15","NHS","99N","Q64","Y57",169397,63968,233365,376198,103436,479634
"30-Sep-15","NHS","99P","Q66","Y57",384644,120997,505641,707716,166593,874309
"30-Sep-15","NHS","99Q","Q66","Y57",129540,38805,168345,223823,51170,274993
"30-Sep-15","NHS","UnA",0,0,131840,45472,177312,0,0,0
"31-Jul-15","LA","E06000001",0,0,44782,14016,58798,72478,20187,92665
"31-Jul-15","LA","E06000002",0,0,73205,26551,99756,107219,31720,138939
"31-Jul-15","LA","E06000003",0,0,66522,20209,86731,107472,27473,134945
"31-Jul-15","LA","E06000004",0,0,88292,32696,120988,150920,42276,193196
"31-Jul-15","LA","E06000005",0,0,49986,17724,67710,82637,22759,105396
"31-Jul-15","LA","E06000006",0,0,53034,17459,70493,97818,28152,125970
"31-Jul-15","LA","E06000007",0,0,92454,31140,123594,160810,44299,205109
"31-Jul-15","LA","E06000008",0,0,58519,29773,88292,108833,38536,147369
"31-Jul-15","LA","E06000009",0,0,63332,19190,82522,112370,29030,141400
"31-Jul-15","LA","E06000010",0,0,159194,51293,210487,202325,55264,257589
"31-Jul-15","LA","E06000011",0,0,122221,38117,160338,272607,63400,336007
"31-Jul-15","LA","E06000012",0,0,75542,23892,99434,125404,34423,159827
"31-Jul-15","LA","E06000013",0,0,61812,21510,83322,133409,35351,168760
"31-Jul-15","LA","E06000014",0,0,89929,28620,118549,166104,36331,202435
"31-Jul-15","LA","E06000015",0,0,95746,39159,134905,193588,57835,251423
"31-Jul-15","LA","E06000016",0,0,141624,63407,205031,254324,79488,333812
"31-Jul-15","LA","E06000017",0,0,10314,5882,16196,29838,7768,37606
"31-Jul-15","LA","E06000018",0,0,144416,51543,195959,246983,63854,310837
"31-Jul-15","LA","E06000019",0,0,75148,24043,99191,150027,36060,186087
"31-Jul-15","LA","E06000020",0,0,76381,29502,105883,129499,38953,168452
"31-Jul-15","LA","E06000021",0,0,127255,45273,172528,195150,55077,250227
"31-Jul-15","LA","E06000022",0,0,75101,28029,103130,145883,34214,180097
"31-Jul-15","LA","E06000023",0,0,199544,71972,271516,346951,90541,437492
"31-Jul-15","LA","E06000024",0,0,86756,31142,117898,163910,42225,206135
"31-Jul-15","LA","E06000025",0,0,114610,35954,150564,212159,56948,269107
"31-Jul-15","LA","E06000026",0,0,107629,37879,145508,207877,51298,259175
"31-Jul-15","LA","E06000027",0,0,62476,19460,81936,107155,24920,132075
"31-Jul-15","LA","E06000028",0,0,99491,27988,127479,155209,33524,188733
"31-Jul-15","LA","E06000029",0,0,58269,19370,77639,119566,29443,149009
"31-Jul-15","LA","E06000030",0,0,77177,30367,107544,166065,47973,214038
"31-Jul-15","LA","E06000031",0,0,67076,33928,101004,142582,45817,188399
"31-Jul-15","LA","E06000032",0,0,78956,34249,113205,154310,53679,207989
"31-Jul-15","LA","E06000033",0,0,80338,26586,106924,137929,37869,175798
"31-Jul-15","LA","E06000034",0,0,49987,22669,72656,121434,39415,160849
"31-Jul-15","LA","E06000035",0,0,116849,50291,167140,209266,61839,271105
"31-Jul-15","LA","E06000036",0,0,46459,19415,65874,89178,27389,116567
"31-Jul-15","LA","E06000037",0,0,47436,21638,69074,119666,35728,155394
"31-Jul-15","LA","E06000038",0,0,68189,30107,98296,124171,35076,159247
"31-Jul-15","LA","E06000039",0,0,50441,24919,75360,104010,39014,143024
"31-Jul-15","LA","E06000040",0,0,51643,23682,75325,113296,33039,146335
"31-Jul-15","LA","E06000041",0,0,48634,22857,71491,121369,36497,157866
"31-Jul-15","LA","E06000042",0,0,84383,44685,129068,191521,64181,255702
"31-Jul-15","LA","E06000043",0,0,106676,36709,143385,227451,50661,278112
"31-Jul-15","LA","E06000044",0,0,87181,29793,116974,164660,42800,207460
"31-Jul-15","LA","E06000045",0,0,102282,34032,136314,194254,47887,242141
"31-Jul-15","LA","E06000046",0,0,60512,17593,78105,112702,25691,138393
"31-Jul-15","LA","E06000047",0,0,223520,68036,291556,415740,100217,515957
"31-Jul-15","LA","E06000049",0,0,182316,60689,243005,297777,74930,372707
"31-Jul-15","LA","E06000050",0,0,168942,56412,225354,264903,66123,331026
"31-Jul-15","LA","E06000051",0,0,120264,40996,161260,248550,60017,308567
"31-Jul-15","LA","E06000052",0,0,237959,73324,311283,437101,104218,541319
"31-Jul-15","LA","E06000053",0,0,0,0,0,1876,375,2251
"31-Jul-15","LA","E06000054",0,0,169428,63987,233415,376198,103436,479634
"31-Jul-15","LA","E06000055",0,0,68638,28923,97561,124627,36756,161383
"31-Jul-15","LA","E06000056",0,0,103746,37987,141733,206519,58009,264528
"31-Jul-15","LA","E06000057",0,0,141064,41807,182871,255418,60388,315806
"31-Jul-15","LA","E08000001",0,0,108634,47224,155858,214210,65847,280057
"31-Jul-15","LA","E08000002",0,0,76742,29884,106626,144168,42359,186527
"31-Jul-15","LA","E08000003",0,0,211525,86252,297777,401609,112808,514417
"31-Jul-15","LA","E08000004",0,0,101015,42272,143287,170144,57168,227312
"31-Jul-15","LA","E08000005",0,0,92188,37713,129901,161558,50562,212120
"31-Jul-15","LA","E08000006",0,0,108631,42282,150913,186744,52269,239013
"31-Jul-15","LA","E08000007",0,0,140320,45353,185673,224011,61021,285032
"31-Jul-15","LA","E08000008",0,0,98275,35844,134119,171930,48667,220597
"31-Jul-15","LA","E08000009",0,0,97028,39760,136788,177254,52925,230179
"31-Jul-15","LA","E08000010",0,0,151849,51060,202909,251917,67773,319690
"31-Jul-15","LA","E08000011",0,0,67949,23373,91322,113703,32383,146086
"31-Jul-15","LA","E08000012",0,0,187719,64061,251780,381379,89401,470780
"31-Jul-15","LA","E08000013",0,0,90862,28987,119849,139950,36271,176221
"31-Jul-15","LA","E08000014",0,0,150392,41774,192166,219646,53561,273207
"31-Jul-15","LA","E08000015",0,0,155397,49636,205033,252839,67456,320295
"31-Jul-15","LA","E08000016",0,0,120108,38386,158494,186297,49460,235757
"31-Jul-15","LA","E08000017",0,0,165940,51537,217477,238646,64976,303622
"31-Jul-15","LA","E08000018",0,0,123046,41109,164155,202588,56101,258689
"31-Jul-15","LA","E08000019",0,0,264851,86771,351622,445431,114654,560085
"31-Jul-15","LA","E08000021",0,0,135431,42256,177687,231453,55368,286821
"31-Jul-15","LA","E08000022",0,0,90511,31394,121905,161678,40474,202152
"31-Jul-15","LA","E08000023",0,0,81024,22990,104014,119084,29442,148526
"31-Jul-15","LA","E08000024",0,0,136990,43419,180409,221536,54544,276080
"31-Jul-15","LA","E08000025",0,0,425251,182591,607842,812307,280023,1092330
"31-Jul-15","LA","E08000026",0,0,140852,51281,192133,256633,73177,329810
"31-Jul-15","LA","E08000027",0,0,128064,38163,166227,246783,67644,314427
"31-Jul-15","LA","E08000028",0,0,144976,51391,196367,237462,76867,314329
"31-Jul-15","LA","E08000029",0,0,73443,28042,101485,163587,45274,208861
"31-Jul-15","LA","E08000030",0,0,100919,41901,142820,208276,63885,272161
"31-Jul-15","LA","E08000031",0,0,98268,34319,132587,194708,56849,251557
"31-Jul-15","LA","E08000032",0,0,202516,92564,295080,388064,138305,526369
"31-Jul-15","LA","E08000033",0,0,94345,34927,129272,160676,45679,206355
"31-Jul-15","LA","E08000034",0,0,187375,74670,262045,330310,97969,428279
"31-Jul-15","LA","E08000035",0,0,328602,117618,446220,602915,158573,761488
"31-Jul-15","LA","E08000036",0,0,170245,52994,223239,260843,68865,329708
"31-Jul-15","LA","E08000037",0,0,93356,29409,122765,159800,40198,199998
"31-Jul-15","LA","E09000001",0,0,1622,977,2599,6819,829,7648
"31-Jul-15","LA","E09000002",0,0,75064,33912,108976,136747,57605,194352
"31-Jul-15","LA","E09000003",0,0,102344,49457,151801,282465,86623,369088
"31-Jul-15","LA","E09000004",0,0,75602,34520,110122,181780,54907,236687
"31-Jul-15","LA","E09000005",0,0,119410,48248,167658,244716,72548,317264
"31-Jul-15","LA","E09000006",0,0,92422,49845,142267,247450,70449,317899
"31-Jul-15","LA","E09000007",0,0,97843,29204,127047,187334,42385,229719
"31-Jul-15","LA","E09000008",0,0,133261,56799,190060,281124,91628,372752
"31-Jul-15","LA","E09000009",0,0,141088,58050,199138,262978,79516,342494
"31-Jul-15","LA","E09000010",0,0,113415,50017,163432,239600,80924,320524
"31-Jul-15","LA","E09000011",0,0,107039,48236,155275,200318,63690,264008
"31-Jul-15","LA","E09000012",0,0,76219,25490,101709,198401,58978,257379
"31-Jul-15","LA","E09000013",0,0,76075,21847,97922,145357,33328,178685
"31-Jul-15","LA","E09000014",0,0,113209,46737,159946,204425,58961,263386
"31-Jul-15","LA","E09000015",0,0,78547,33399,111946,187630,55743,243373
"31-Jul-15","LA","E09000016",0,0,94269,34642,128911,189960,52120,242080
"31-Jul-15","LA","E09000017",0,0,87874,39233,127107,219261,67547,286808
"31-Jul-15","LA","E09000018",0,0,106547,43814,150361,201963,60444,262407
"31-Jul-15","LA","E09000019",0,0,80205,22329,102534,177326,38345,215671
"31-Jul-15","LA","E09000020",0,0,48266,12617,60883,128272,27322,155594
"31-Jul-15","LA","E09000021",0,0,61779,26860,88639,131100,35693,166793
"31-Jul-15","LA","E09000022",0,0,138062,40927,178989,252274,61968,314242
"31-Jul-15","LA","E09000023",0,0,121014,42096,163110,220491,65689,286180
"31-Jul-15","LA","E09000024",0,0,71350,23582,94932,158248,44975,203223
"31-Jul-15","LA","E09000025",0,0,93486,47986,141472,237000,81227,318227
"31-Jul-15","LA","E09000026",0,0,113181,53245,166426,215220,73052,288272
"31-Jul-15","LA","E09000027",0,0,47253,24491,71744,148509,42856,191365
"31-Jul-15","LA","E09000028",0,0,107973,36802,144775,237370,61095,298465
"31-Jul-15","LA","E09000029",0,0,67163,30214,97377,151229,44685,195914
"31-Jul-15","LA","E09000030",0,0,81775,30997,112772,212378,60512,272890
"31-Jul-15","LA","E09000031",0,0,84021,35000,119021,202000,63797,265797
"31-Jul-15","LA","E09000032",0,0,107337,38696,146033,252281,58235,310516
"31-Jul-15","LA","E09000033",0,0,94042,22863,116905,187732,39109,226841
"31-Jul-15","LA","E10000002",0,0,156440,74278,230718,398226,117883,516109
"31-Jul-15","LA","E10000003",0,0,232332,83347,315679,502718,130038,632756
"31-Jul-15","LA","E10000006",0,0,200879,67156,268035,404065,94005,498070
"31-Jul-15","LA","E10000007",0,0,304120,97098,401218,621361,154799,776160
"31-Jul-15","LA","E10000008",0,0,344122,102614,446736,616507,141545,758052
"31-Jul-15","LA","E10000009",0,0,165619,49997,215616,339403,77318,416721
"31-Jul-15","LA","E10000011",0,0,217937,66470,284407,429506,104896,534402
"31-Jul-15","LA","E10000012",0,0,573676,193744,767420,1118167,298238,1416405
"31-Jul-15","LA","E10000013",0,0,196381,83249,279630,482920,122734,605654
"31-Jul-15","LA","E10000014",0,0,520902,189098,710000,1056193,281537,1337730
"31-Jul-15","LA","E10000015",0,0,472193,193035,665228,882289,258414,1140703
"31-Jul-15","LA","E10000016",0,0,485846,205091,690937,1167474,326038,1493512
"31-Jul-15","LA","E10000017",0,0,491265,176782,668047,936102,243975,1180077
"31-Jul-15","LA","E10000018",0,0,263267,90440,353707,526919,134656,661575
"31-Jul-15","LA","E10000019",0,0,291844,90407,382251,583644,140725,724369
"31-Jul-15","LA","E10000020",0,0,410619,111643,522262,704533,166507,871040
"31-Jul-15","LA","E10000021",0,0,286993,106196,393189,547209,159224,706433
"31-Jul-15","LA","E10000023",0,0,244572,79791,324363,484424,118317,602741
"31-Jul-15","LA","E10000024",0,0,346566,115093,461659,633576,162640,796216
"31-Jul-15","LA","E10000025",0,0,259589,103697,363286,525973,140224,666197
"31-Jul-15","LA","E10000027",0,0,248078,78019,326097,429382,108722,538104
"31-Jul-15","LA","E10000028",0,0,348504,117158,465662,686778,170229,857007
"31-Jul-15","LA","E10000029",0,0,341132,106490,447622,583320,151146,734466
"31-Jul-15","LA","E10000030",0,0,350020,165180,515200,899844,252270,1152114
"31-Jul-15","LA","E10000031",0,0,241180,78551,319731,436800,111929,548729
"31-Jul-15","LA","E10000032",0,0,324175,122619,446794,653832,167524,821356
"31-Jul-15","LA","E10000034",0,0,223141,79455,302596,457206,114962,572168
"31-Jul-15","LA","UnA",0,0,131953,45438,177391,0,0,0
"31-Aug-15","LA","E06000001",0,0,44686,14030,58716,72478,20187,92665
"31-Aug-15","LA","E06000002",0,0,73273,26652,99925,107219,31720,138939
"31-Aug-15","LA","E06000003",0,0,66462,20181,86643,107472,27473,134945
"31-Aug-15","LA","E06000004",0,0,88262,32836,121098,150920,42276,193196
"31-Aug-15","LA","E06000005",0,0,50210,17798,68008,82637,22759,105396
"31-Aug-15","LA","E06000006",0,0,53139,17486,70625,97818,28152,125970
"31-Aug-15","LA","E06000007",0,0,92508,31181,123689,160810,44299,205109
"31-Aug-15","LA","E06000008",0,0,58527,29793,88320,108833,38536,147369
"31-Aug-15","LA","E06000009",0,0,63085,19116,82201,112370,29030,141400
"31-Aug-15","LA","E06000010",0,0,159643,51474,211117,202325,55264,257589
"31-Aug-15","LA","E06000011",0,0,122216,38079,160295,272607,63400,336007
"31-Aug-15","LA","E06000012",0,0,75376,23845,99221,125404,34423,159827
"31-Aug-15","LA","E06000013",0,0,61705,21486,83191,133409,35351,168760
"31-Aug-15","LA","E06000014",0,0,89671,28533,118204,166104,36331,202435
"31-Aug-15","LA","E06000015",0,0,95561,39268,134829,193588,57835,251423
"31-Aug-15","LA","E06000016",0,0,141350,63305,204655,254324,79488,333812
"31-Aug-15","LA","E06000017",0,0,10213,5845,16058,29838,7768,37606
"31-Aug-15","LA","E06000018",0,0,144560,51429,195989,246983,63854,310837
"31-Aug-15","LA","E06000019",0,0,74964,24100,99064,150027,36060,186087
"31-Aug-15","LA","E06000020",0,0,76243,29525,105768,129499,38953,168452
"31-Aug-15","LA","E06000021",0,0,127160,45261,172421,195150,55077,250227
"31-Aug-15","LA","E06000022",0,0,75121,28065,103186,145883,34214,180097
"31-Aug-15","LA","E06000023",0,0,199216,72150,271366,346951,90541,437492
"31-Aug-15","LA","E06000024",0,0,86706,31192,117898,163910,42225,206135
"31-Aug-15","LA","E06000025",0,0,114730,35934,150664,212159,56948,269107
"31-Aug-15","LA","E06000026",0,0,107631,37904,145535,207877,51298,259175
"31-Aug-15","LA","E06000027",0,0,62598,19445,82043,107155,24920,132075
"31-Aug-15","LA","E06000028",0,0,99696,28055,127751,155209,33524,188733
"31-Aug-15","LA","E06000029",0,0,57897,19278,77175,119566,29443,149009
"31-Aug-15","LA","E06000030",0,0,76985,30458,107443,166065,47973,214038
"31-Aug-15","LA","E06000031",0,0,67176,33946,101122,142582,45817,188399
"31-Aug-15","LA","E06000032",0,0,79249,34525,113774,154310,53679,207989
"31-Aug-15","LA","E06000033",0,0,80387,26521,106908,137929,37869,175798
"31-Aug-15","LA","E06000034",0,0,50119,22714,72833,121434,39415,160849
"31-Aug-15","LA","E06000035",0,0,116834,50381,167215,209266,61839,271105
"31-Aug-15","LA","E06000036",0,0,46466,19485,65951,89178,27389,116567
"31-Aug-15","LA","E06000037",0,0,47375,21617,68992,119666,35728,155394
"31-Aug-15","LA","E06000038",0,0,68329,30255,98584,124171,35076,159247
"31-Aug-15","LA","E06000039",0,0,50447,25001,75448,104010,39014,143024
"31-Aug-15","LA","E06000040",0,0,51737,23719,75456,113296,33039,146335
"31-Aug-15","LA","E06000041",0,0,48600,22862,71462,121369,36497,157866
"31-Aug-15","LA","E06000042",0,0,84106,44810,128916,191521,64181,255702
"31-Aug-15","LA","E06000043",0,0,107096,36815,143911,227451,50661,278112
"31-Aug-15","LA","E06000044",0,0,87288,29731,117019,164660,42800,207460
"31-Aug-15","LA","E06000045",0,0,102164,34095,136259,194254,47887,242141
"31-Aug-15","LA","E06000046",0,0,60440,17569,78009,112702,25691,138393
"31-Aug-15","LA","E06000047",0,0,223544,68007,291551,415740,100217,515957
"31-Aug-15","LA","E06000049",0,0,182333,60799,243132,297777,74930,372707
"31-Aug-15","LA","E06000050",0,0,169021,56427,225448,264903,66123,331026
"31-Aug-15","LA","E06000051",0,0,120609,41110,161719,248550,60017,308567
"31-Aug-15","LA","E06000052",0,0,238007,73326,311333,437101,104218,541319
"31-Aug-15","LA","E06000053",0,0,0,0,0,1876,375,2251
"31-Aug-15","LA","E06000054",0,0,169362,63912,233274,376198,103436,479634
"31-Aug-15","LA","E06000055",0,0,68594,28897,97491,124627,36756,161383
"31-Aug-15","LA","E06000056",0,0,103875,38069,141944,206519,58009,264528
"31-Aug-15","LA","E06000057",0,0,141059,41797,182856,255418,60388,315806
"31-Aug-15","LA","E08000001",0,0,108472,47273,155745,214210,65847,280057
"31-Aug-15","LA","E08000002",0,0,76683,29941,106624,144168,42359,186527
"31-Aug-15","LA","E08000003",0,0,211778,86570,298348,401609,112808,514417
"31-Aug-15","LA","E08000004",0,0,100856,42307,143163,170144,57168,227312
"31-Aug-15","LA","E08000005",0,0,92252,37799,130051,161558,50562,212120
"31-Aug-15","LA","E08000006",0,0,109237,42496,151733,186744,52269,239013
"31-Aug-15","LA","E08000007",0,0,140238,45382,185620,224011,61021,285032
"31-Aug-15","LA","E08000008",0,0,98326,35989,134315,171930,48667,220597
"31-Aug-15","LA","E08000009",0,0,97109,39877,136986,177254,52925,230179
"31-Aug-15","LA","E08000010",0,0,151828,51150,202978,251917,67773,319690
"31-Aug-15","LA","E08000011",0,0,67820,23289,91109,113703,32383,146086
"31-Aug-15","LA","E08000012",0,0,187527,64177,251704,381379,89401,470780
"31-Aug-15","LA","E08000013",0,0,90935,29001,119936,139950,36271,176221
"31-Aug-15","LA","E08000014",0,0,150458,41869,192327,219646,53561,273207
"31-Aug-15","LA","E08000015",0,0,155297,49553,204850,252839,67456,320295
"31-Aug-15","LA","E08000016",0,0,120148,38407,158555,186297,49460,235757
"31-Aug-15","LA","E08000017",0,0,166025,51458,217483,238646,64976,303622
"31-Aug-15","LA","E08000018",0,0,122715,40949,163664,202588,56101,258689
"31-Aug-15","LA","E08000019",0,0,265142,86828,351970,445431,114654,560085
"31-Aug-15","LA","E08000021",0,0,135648,42466,178114,231453,55368,286821
"31-Aug-15","LA","E08000022",0,0,90484,31365,121849,161678,40474,202152
"31-Aug-15","LA","E08000023",0,0,80925,22991,103916,119084,29442,148526
"31-Aug-15","LA","E08000024",0,0,136992,43280,180272,221536,54544,276080
"31-Aug-15","LA","E08000025",0,0,425485,182960,608445,812307,280023,1092330
"31-Aug-15","LA","E08000026",0,0,140843,51371,192214,256633,73177,329810
"31-Aug-15","LA","E08000027",0,0,128242,38245,166487,246783,67644,314427
"31-Aug-15","LA","E08000028",0,0,144977,51801,196778,237462,76867,314329
"31-Aug-15","LA","E08000029",0,0,73399,28027,101426,163587,45274,208861
"31-Aug-15","LA","E08000030",0,0,100641,41826,142467,208276,63885,272161
"31-Aug-15","LA","E08000031",0,0,98060,34420,132480,194708,56849,251557
"31-Aug-15","LA","E08000032",0,0,202386,92599,294985,388064,138305,526369
"31-Aug-15","LA","E08000033",0,0,94417,34915,129332,160676,45679,206355
"31-Aug-15","LA","E08000034",0,0,186965,74532,261497,330310,97969,428279
"31-Aug-15","LA","E08000035",0,0,328547,117794,446341,602915,158573,761488
"31-Aug-15","LA","E08000036",0,0,170307,52951,223258,260843,68865,329708
"31-Aug-15","LA","E08000037",0,0,93441,29464,122905,159800,40198,199998
"31-Aug-15","LA","E09000001",0,0,1653,1000,2653,6819,829,7648
"31-Aug-15","LA","E09000002",0,0,75038,34009,109047,136747,57605,194352
"31-Aug-15","LA","E09000003",0,0,102396,49609,152005,282465,86623,369088
"31-Aug-15","LA","E09000004",0,0,75853,34693,110546,181780,54907,236687
"31-Aug-15","LA","E09000005",0,0,119582,48436,168018,244716,72548,317264
"31-Aug-15","LA","E09000006",0,0,92645,49896,142541,247450,70449,317899
"31-Aug-15","LA","E09000007",0,0,97953,29214,127167,187334,42385,229719
"31-Aug-15","LA","E09000008",0,0,133154,56954,190108,281124,91628,372752
"31-Aug-15","LA","E09000009",0,0,140961,58063,199024,262978,79516,342494
"31-Aug-15","LA","E09000010",0,0,113849,50165,164014,239600,80924,320524
"31-Aug-15","LA","E09000011",0,0,107103,48306,155409,200318,63690,264008
"31-Aug-15","LA","E09000012",0,0,76221,25538,101759,198401,58978,257379
"31-Aug-15","LA","E09000013",0,0,76116,21908,98024,145357,33328,178685
"31-Aug-15","LA","E09000014",0,0,113500,46869,160369,204425,58961,263386
"31-Aug-15","LA","E09000015",0,0,78483,33453,111936,187630,55743,243373
"31-Aug-15","LA","E09000016",0,0,94566,34676,129242,189960,52120,242080
"31-Aug-15","LA","E09000017",0,0,87955,39342,127297,219261,67547,286808
"31-Aug-15","LA","E09000018",0,0,106549,43893,150442,201963,60444,262407
"31-Aug-15","LA","E09000019",0,0,80668,22527,103195,177326,38345,215671
"31-Aug-15","LA","E09000020",0,0,48390,12708,61098,128272,27322,155594
"31-Aug-15","LA","E09000021",0,0,61781,26949,88730,131100,35693,166793
"31-Aug-15","LA","E09000022",0,0,137955,41008,178963,252274,61968,314242
"31-Aug-15","LA","E09000023",0,0,121272,42291,163563,220491,65689,286180
"31-Aug-15","LA","E09000024",0,0,71203,23638,94841,158248,44975,203223
"31-Aug-15","LA","E09000025",0,0,93666,48198,141864,237000,81227,318227
"31-Aug-15","LA","E09000026",0,0,113152,53558,166710,215220,73052,288272
"31-Aug-15","LA","E09000027",0,0,47289,24402,71691,148509,42856,191365
"31-Aug-15","LA","E09000028",0,0,107953,36912,144865,237370,61095,298465
"31-Aug-15","LA","E09000029",0,0,67135,30190,97325,151229,44685,195914
"31-Aug-15","LA","E09000030",0,0,81887,31087,112974,212378,60512,272890
"31-Aug-15","LA","E09000031",0,0,84258,35081,119339,202000,63797,265797
"31-Aug-15","LA","E09000032",0,0,107305,38720,146025,252281,58235,310516
"31-Aug-15","LA","E09000033",0,0,94260,22990,117250,187732,39109,226841
"31-Aug-15","LA","E10000002",0,0,156409,74489,230898,398226,117883,516109
"31-Aug-15","LA","E10000003",0,0,232024,83373,315397,502718,130038,632756
"31-Aug-15","LA","E10000006",0,0,200704,67083,267787,404065,94005,498070
"31-Aug-15","LA","E10000007",0,0,304009,97048,401057,621361,154799,776160
"31-Aug-15","LA","E10000008",0,0,344132,102591,446723,616507,141545,758052
"31-Aug-15","LA","E10000009",0,0,165539,49898,215437,339403,77318,416721
"31-Aug-15","LA","E10000011",0,0,217982,66558,284540,429506,104896,534402
"31-Aug-15","LA","E10000012",0,0,573920,194058,767978,1118167,298238,1416405
"31-Aug-15","LA","E10000013",0,0,196377,83308,279685,482920,122734,605654
"31-Aug-15","LA","E10000014",0,0,521025,189278,710303,1056193,281537,1337730
"31-Aug-15","LA","E10000015",0,0,472541,193723,666264,882289,258414,1140703
"31-Aug-15","LA","E10000016",0,0,485921,205166,691087,1167474,326038,1493512
"31-Aug-15","LA","E10000017",0,0,490957,176699,667656,936102,243975,1180077
"31-Aug-15","LA","E10000018",0,0,263077,90617,353694,526919,134656,661575
"31-Aug-15","LA","E10000019",0,0,291070,90289,381359,583644,140725,724369
"31-Aug-15","LA","E10000020",0,0,409964,111648,521612,704533,166507,871040
"31-Aug-15","LA","E10000021",0,0,286696,106370,393066,547209,159224,706433
"31-Aug-15","LA","E10000023",0,0,243892,79569,323461,484424,118317,602741
"31-Aug-15","LA","E10000024",0,0,347034,115321,462355,633576,162640,796216
"31-Aug-15","LA","E10000025",0,0,259589,103943,363532,525973,140224,666197
"31-Aug-15","LA","E10000027",0,0,248127,78059,326186,429382,108722,538104
"31-Aug-15","LA","E10000028",0,0,348043,117191,465234,686778,170229,857007
"31-Aug-15","LA","E10000029",0,0,340992,106547,447539,583320,151146,734466
"31-Aug-15","LA","E10000030",0,0,349395,165152,514547,899844,252270,1152114
"31-Aug-15","LA","E10000031",0,0,241236,78668,319904,436800,111929,548729
"31-Aug-15","LA","E10000032",0,0,324244,122734,446978,653832,167524,821356
"31-Aug-15","LA","E10000034",0,0,223336,79586,302922,457206,114962,572168
"31-Aug-15","LA","UnA",0,0,131604,45359,176963,0,0,0
"30-Sep-15","LA","E06000001",0,0,44722,13982,58704,72478,20187,92665
"30-Sep-15","LA","E06000002",0,0,73233,26585,99818,107219,31720,138939
"30-Sep-15","LA","E06000003",0,0,66512,20234,86746,107472,27473,134945
"30-Sep-15","LA","E06000004",0,0,88384,32904,121288,150920,42276,193196
"30-Sep-15","LA","E06000005",0,0,50259,17826,68085,82637,22759,105396
"30-Sep-15","LA","E06000006",0,0,53203,17545,70748,97818,28152,125970
"30-Sep-15","LA","E06000007",0,0,92620,31244,123864,160810,44299,205109
"30-Sep-15","LA","E06000008",0,0,58495,29742,88237,108833,38536,147369
"30-Sep-15","LA","E06000009",0,0,63106,19086,82192,112370,29030,141400
"30-Sep-15","LA","E06000010",0,0,159797,51503,211300,202325,55264,257589
"30-Sep-15","LA","E06000011",0,0,122134,38075,160209,272607,63400,336007
"30-Sep-15","LA","E06000012",0,0,75224,23898,99122,125404,34423,159827
"30-Sep-15","LA","E06000013",0,0,61606,21389,82995,133409,35351,168760
"30-Sep-15","LA","E06000014",0,0,89491,28475,117966,166104,36331,202435
"30-Sep-15","LA","E06000015",0,0,95588,39400,134988,193588,57835,251423
"30-Sep-15","LA","E06000016",0,0,141685,63432,205117,254324,79488,333812
"30-Sep-15","LA","E06000017",0,0,10176,5864,16040,29838,7768,37606
"30-Sep-15","LA","E06000018",0,0,144019,51275,195294,246983,63854,310837
"30-Sep-15","LA","E06000019",0,0,75025,24073,99098,150027,36060,186087
"30-Sep-15","LA","E06000020",0,0,76283,29597,105880,129499,38953,168452
"30-Sep-15","LA","E06000021",0,0,127262,45254,172516,195150,55077,250227
"30-Sep-15","LA","E06000022",0,0,75050,28065,103115,145883,34214,180097
"30-Sep-15","LA","E06000023",0,0,199341,72306,271647,346951,90541,437492
"30-Sep-15","LA","E06000024",0,0,86515,31190,117705,163910,42225,206135
"30-Sep-15","LA","E06000025",0,0,115012,35907,150919,212159,56948,269107
"30-Sep-15","LA","E06000026",0,0,107697,37869,145566,207877,51298,259175
"30-Sep-15","LA","E06000027",0,0,62687,19459,82146,107155,24920,132075
"30-Sep-15","LA","E06000028",0,0,99948,28142,128090,155209,33524,188733
"30-Sep-15","LA","E06000029",0,0,57838,19310,77148,119566,29443,149009
"30-Sep-15","LA","E06000030",0,0,76955,30421,107376,166065,47973,214038
"30-Sep-15","LA","E06000031",0,0,67091,33901,100992,142582,45817,188399
"30-Sep-15","LA","E06000032",0,0,79301,34676,113977,154310,53679,207989
"30-Sep-15","LA","E06000033",0,0,80392,26465,106857,137929,37869,175798
"30-Sep-15","LA","E06000034",0,0,50014,22866,72880,121434,39415,160849
"30-Sep-15","LA","E06000035",0,0,116782,50507,167289,209266,61839,271105
"30-Sep-15","LA","E06000036",0,0,46508,19496,66004,89178,27389,116567
"30-Sep-15","LA","E06000037",0,0,47391,21585,68976,119666,35728,155394
"30-Sep-15","LA","E06000038",0,0,68419,30263,98682,124171,35076,159247
"30-Sep-15","LA","E06000039",0,0,50410,24952,75362,104010,39014,143024
"30-Sep-15","LA","E06000040",0,0,51521,23771,75292,113296,33039,146335
"30-Sep-15","LA","E06000041",0,0,48636,22882,71518,121369,36497,157866
"30-Sep-15","LA","E06000042",0,0,83623,44718,128341,191521,64181,255702
"30-Sep-15","LA","E06000043",0,0,107008,36822,143830,227451,50661,278112
"30-Sep-15","LA","E06000044",0,0,87200,29722,116922,164660,42800,207460
"30-Sep-15","LA","E06000045",0,0,102055,34146,136201,194254,47887,242141
"30-Sep-15","LA","E06000046",0,0,60352,17492,77844,112702,25691,138393
"30-Sep-15","LA","E06000047",0,0,223634,67960,291594,415740,100217,515957
"30-Sep-15","LA","E06000049",0,0,181994,60710,242704,297777,74930,372707
"30-Sep-15","LA","E06000050",0,0,169139,56349,225488,264903,66123,331026
"30-Sep-15","LA","E06000051",0,0,120605,41016,161621,248550,60017,308567
"30-Sep-15","LA","E06000052",0,0,237892,73370,311262,437101,104218,541319
"30-Sep-15","LA","E06000053",0,0,0,0,0,1876,375,2251
"30-Sep-15","LA","E06000054",0,0,169397,63968,233365,376198,103436,479634
"30-Sep-15","LA","E06000055",0,0,68750,29039,97789,124627,36756,161383
"30-Sep-15","LA","E06000056",0,0,103733,38149,141882,206519,58009,264528
"30-Sep-15","LA","E06000057",0,0,141041,41779,182820,255418,60388,315806
"30-Sep-15","LA","E08000001",0,0,108104,47190,155294,214210,65847,280057
"30-Sep-15","LA","E08000002",0,0,76731,29917,106648,144168,42359,186527
"30-Sep-15","LA","E08000003",0,0,211842,86750,298592,401609,112808,514417
"30-Sep-15","LA","E08000004",0,0,100776,42328,143104,170144,57168,227312
"30-Sep-15","LA","E08000005",0,0,92025,37737,129762,161558,50562,212120
"30-Sep-15","LA","E08000006",0,0,109123,42390,151513,186744,52269,239013
"30-Sep-15","LA","E08000007",0,0,140069,45424,185493,224011,61021,285032
"30-Sep-15","LA","E08000008",0,0,98165,35889,134054,171930,48667,220597
"30-Sep-15","LA","E08000009",0,0,97120,39897,137017,177254,52925,230179
"30-Sep-15","LA","E08000010",0,0,152132,51175,203307,251917,67773,319690
"30-Sep-15","LA","E08000011",0,0,67935,23219,91154,113703,32383,146086
"30-Sep-15","LA","E08000012",0,0,187411,64322,251733,381379,89401,470780
"30-Sep-15","LA","E08000013",0,0,90977,29022,119999,139950,36271,176221
"30-Sep-15","LA","E08000014",0,0,150603,41830,192433,219646,53561,273207
"30-Sep-15","LA","E08000015",0,0,155160,49542,204702,252839,67456,320295
"30-Sep-15","LA","E08000016",0,0,120286,38429,158715,186297,49460,235757
"30-Sep-15","LA","E08000017",0,0,166007,51500,217507,238646,64976,303622
"30-Sep-15","LA","E08000018",0,0,122630,40884,163514,202588,56101,258689
"30-Sep-15","LA","E08000019",0,0,265180,86864,352044,445431,114654,560085
"30-Sep-15","LA","E08000021",0,0,135706,42682,178388,231453,55368,286821
"30-Sep-15","LA","E08000022",0,0,90530,31427,121957,161678,40474,202152
"30-Sep-15","LA","E08000023",0,0,80979,22913,103892,119084,29442,148526
"30-Sep-15","LA","E08000024",0,0,136651,43285,179936,221536,54544,276080
"30-Sep-15","LA","E08000025",0,0,424748,183403,608151,812307,280023,1092330
"30-Sep-15","LA","E08000026",0,0,141091,51683,192774,256633,73177,329810
"30-Sep-15","LA","E08000027",0,0,128266,38154,166420,246783,67644,314427
"30-Sep-15","LA","E08000028",0,0,145438,52277,197715,237462,76867,314329
"30-Sep-15","LA","E08000029",0,0,73245,28015,101260,163587,45274,208861
"30-Sep-15","LA","E08000030",0,0,100528,41910,142438,208276,63885,272161
"30-Sep-15","LA","E08000031",0,0,97933,34560,132493,194708,56849,251557
"30-Sep-15","LA","E08000032",0,0,202397,92703,295100,388064,138305,526369
"30-Sep-15","LA","E08000033",0,0,94167,34785,128952,160676,45679,206355
"30-Sep-15","LA","E08000034",0,0,186684,74495,261179,330310,97969,428279
"30-Sep-15","LA","E08000035",0,0,328406,118144,446550,602915,158573,761488
"30-Sep-15","LA","E08000036",0,0,170118,52961,223079,260843,68865,329708
"30-Sep-15","LA","E08000037",0,0,93448,29538,122986,159800,40198,199998
"30-Sep-15","LA","E09000001",0,0,1684,954,2638,6819,829,7648
"30-Sep-15","LA","E09000002",0,0,75139,34192,109331,136747,57605,194352
"30-Sep-15","LA","E09000003",0,0,102209,49645,151854,282465,86623,369088
"30-Sep-15","LA","E09000004",0,0,76018,34698,110716,181780,54907,236687
"30-Sep-15","LA","E09000005",0,0,119236,48579,167815,244716,72548,317264
"30-Sep-15","LA","E09000006",0,0,92381,49959,142340,247450,70449,317899
"30-Sep-15","LA","E09000007",0,0,98058,29269,127327,187334,42385,229719
"30-Sep-15","LA","E09000008",0,0,133338,57079,190417,281124,91628,372752
"30-Sep-15","LA","E09000009",0,0,140813,58317,199130,262978,79516,342494
"30-Sep-15","LA","E09000010",0,0,113859,50388,164247,239600,80924,320524
"30-Sep-15","LA","E09000011",0,0,106681,48272,154953,200318,63690,264008
"30-Sep-15","LA","E09000012",0,0,75748,25516,101264,198401,58978,257379
"30-Sep-15","LA","E09000013",0,0,76115,21966,98081,145357,33328,178685
"30-Sep-15","LA","E09000014",0,0,113376,46968,160344,204425,58961,263386
"30-Sep-15","LA","E09000015",0,0,78269,33505,111774,187630,55743,243373
"30-Sep-15","LA","E09000016",0,0,94701,34758,129459,189960,52120,242080
"30-Sep-15","LA","E09000017",0,0,87770,39395,127165,219261,67547,286808
"30-Sep-15","LA","E09000018",0,0,106704,44191,150895,201963,60444,262407
"30-Sep-15","LA","E09000019",0,0,80889,22724,103613,177326,38345,215671
"30-Sep-15","LA","E09000020",0,0,48742,12814,61556,128272,27322,155594
"30-Sep-15","LA","E09000021",0,0,61802,26984,88786,131100,35693,166793
"30-Sep-15","LA","E09000022",0,0,137776,41037,178813,252274,61968,314242
"30-Sep-15","LA","E09000023",0,0,121523,42495,164018,220491,65689,286180
"30-Sep-15","LA","E09000024",0,0,71132,23773,94905,158248,44975,203223
"30-Sep-15","LA","E09000025",0,0,93350,48328,141678,237000,81227,318227
"30-Sep-15","LA","E09000026",0,0,112837,53639,166476,215220,73052,288272
"30-Sep-15","LA","E09000027",0,0,47401,24423,71824,148509,42856,191365
"30-Sep-15","LA","E09000028",0,0,107881,36983,144864,237370,61095,298465
"30-Sep-15","LA","E09000029",0,0,67290,30442,97732,151229,44685,195914
"30-Sep-15","LA","E09000030",0,0,81671,31139,112810,212378,60512,272890
"30-Sep-15","LA","E09000031",0,0,84232,35114,119346,202000,63797,265797
"30-Sep-15","LA","E09000032",0,0,107217,38923,146140,252281,58235,310516
"30-Sep-15","LA","E09000033",0,0,94148,22977,117125,187732,39109,226841
"30-Sep-15","LA","E10000002",0,0,156499,74486,230985,398226,117883,516109
"30-Sep-15","LA","E10000003",0,0,231881,83234,315115,502718,130038,632756
"30-Sep-15","LA","E10000006",0,0,200453,67059,267512,404065,94005,498070
"30-Sep-15","LA","E10000007",0,0,303546,96857,400403,621361,154799,776160
"30-Sep-15","LA","E10000008",0,0,343800,102474,446274,616507,141545,758052
"30-Sep-15","LA","E10000009",0,0,165336,49805,215141,339403,77318,416721
"30-Sep-15","LA","E10000011",0,0,217805,66532,284337,429506,104896,534402
"30-Sep-15","LA","E10000012",0,0,573620,194039,767659,1118167,298238,1416405
"30-Sep-15","LA","E10000013",0,0,196642,83419,280061,482920,122734,605654
"30-Sep-15","LA","E10000014",0,0,521332,189243,710575,1056193,281537,1337730
"30-Sep-15","LA","E10000015",0,0,472061,193942,666003,882289,258414,1140703
"30-Sep-15","LA","E10000016",0,0,485995,205109,691104,1167474,326038,1493512
"30-Sep-15","LA","E10000017",0,0,490550,176584,667134,936102,243975,1180077
"30-Sep-15","LA","E10000018",0,0,262937,90642,353579,526919,134656,661575
"30-Sep-15","LA","E10000019",0,0,290501,90144,380645,583644,140725,724369
"30-Sep-15","LA","E10000020",0,0,409780,111715,521495,704533,166507,871040
"30-Sep-15","LA","E10000021",0,0,286360,106325,392685,547209,159224,706433
"30-Sep-15","LA","E10000023",0,0,243209,79434,322643,484424,118317,602741
"30-Sep-15","LA","E10000024",0,0,346609,115182,461791,633576,162640,796216
"30-Sep-15","LA","E10000025",0,0,259275,104025,363300,525973,140224,666197
"30-Sep-15","LA","E10000027",0,0,248553,78021,326574,429382,108722,538104
"30-Sep-15","LA","E10000028",0,0,348033,117237,465270,686778,170229,857007
"30-Sep-15","LA","E10000029",0,0,340706,106349,447055,583320,151146,734466
"30-Sep-15","LA","E10000030",0,0,349028,165526,514554,899844,252270,1152114
"30-Sep-15","LA","E10000031",0,0,241301,78690,319991,436800,111929,548729
"30-Sep-15","LA","E10000032",0,0,323864,122805,446669,653832,167524,821356
"30-Sep-15","LA","E10000034",0,0,223234,79462,302696,457206,114962,572168
"30-Sep-15","LA","UnA",0,0,131840,45472,177312,0,0,0
